R_TEC_AMMONIUM	R_TEC_AMMONIUM
R_TEC_CARBON-DIOXIDE	R_TEC_CARBON-DIOXIDE
R_TEC_CO+2	R_TEC_CO+2
R_TEC_CPD-3	R_TEC_CPD-3
R_TEC_FE+2	R_TEC_FE+2
R_TEC_GLC	R_TEC_GLC
R_TEC_MG+2	R_TEC_MG+2
R_TEC_NITRATE	R_TEC_NITRATE
R_TEC_OXYGEN-MOLECULE	R_TEC_OXYGEN-MOLECULE
R_TEC_Pi	R_TEC_Pi
R_TEC_SUCROSE	R_TEC_SUCROSE
R_TEC_SULFATE	R_TEC_SULFATE
R_TEC_WATER	R_TEC_WATER
R_TEH_Light	R_TEH_Light
R_TEH_Starch	R_TEH_Starch
ARGCons_tx	ARGCons_tx
ASNCons_tx	ASNCons_tx
CYSCons_tx	CYSCons_tx
GLNCons_tx	GLNCons_tx
GLTCons_tx	GLTCons_tx
GLYCons_tx	GLYCons_tx
HISCons_tx	HISCons_tx
ILECons_tx	ILECons_tx
L-ALPHA-ALANINECons_tx	L-ALPHA-ALANINECons_tx
L-ASPARTATECons_tx	L-ASPARTATECons_tx
LEUCons_tx	LEUCons_tx
LYSCons_tx	LYSCons_tx
METCons_tx	METCons_tx
PHECons_tx	PHECons_tx
PROCons_tx	PROCons_tx
R_TCE_ADENOSYL-HOMO-CYS	R_TCE_ADENOSYL-HOMO-CYS
R_TCE_ARG	R_TCE_ARG
R_TCE_ASCORBATE	R_TCE_ASCORBATE
R_TCE_ASN	R_TCE_ASN
R_TCE_ATP	R_TCE_ATP
R_TCE_BETA-D-FRUCTOSE	R_TCE_BETA-D-FRUCTOSE
R_TCE_CARBON-DIOXIDE	R_TCE_CARBON-DIOXIDE
R_TCE_CHOLINE	R_TCE_CHOLINE
R_TCE_CIT	R_TCE_CIT
R_TCE_CO-A	R_TCE_CO-A
R_TCE_CONIFERYL-ALCOHOL	R_TCE_CONIFERYL-ALCOHOL
R_TCE_COUMARYL-ALCOHOL	R_TCE_COUMARYL-ALCOHOL
R_TCE_CPD-8046	R_TCE_CPD-8046
R_TCE_CTP	R_TCE_CTP
R_TCE_CYS	R_TCE_CYS
R_TCE_DATP	R_TCE_DATP
R_TCE_DCTP	R_TCE_DCTP
R_TCE_DGTP	R_TCE_DGTP
R_TCE_FAD	R_TCE_FAD
R_TCE_GLC	R_TCE_GLC
R_TCE_GLN	R_TCE_GLN
R_TCE_GLT	R_TCE_GLT
R_TCE_GLY	R_TCE_GLY
R_TCE_GTP	R_TCE_GTP
R_TCE_HCO3	R_TCE_HCO3
R_TCE_HIS	R_TCE_HIS
R_TCE_ILE	R_TCE_ILE
R_TCE_L-ALPHA-ALANINE	R_TCE_L-ALPHA-ALANINE
R_TCE_L-ARABINOSE	R_TCE_L-ARABINOSE
R_TCE_L-ASPARTATE	R_TCE_L-ASPARTATE
R_TCE_L-GALACTOSE	R_TCE_L-GALACTOSE
R_TCE_LEU	R_TCE_LEU
R_TCE_LINOLEIC_ACID	R_TCE_LINOLEIC_ACID
R_TCE_LINOLENIC_ACID	R_TCE_LINOLENIC_ACID
R_TCE_LYS	R_TCE_LYS
R_TCE_MAL	R_TCE_MAL
R_TCE_MET	R_TCE_MET
R_TCE_MYO-INOSITOL	R_TCE_MYO-INOSITOL
R_TCE_OLEATE-CPD	R_TCE_OLEATE-CPD
R_TCE_OXALACETIC_ACID	R_TCE_OXALACETIC_ACID
R_TCE_OXYGEN-MOLECULE	R_TCE_OXYGEN-MOLECULE
R_TCE_PALMITATE	R_TCE_PALMITATE
R_TCE_PHE	R_TCE_PHE
R_TCE_PRO	R_TCE_PRO
R_TCE_PROTON	R_TCE_PROTON
R_TCE_PYRIDOXAL_PHOSPHATE	R_TCE_PYRIDOXAL_PHOSPHATE
R_TCE_RHAMNOSE	R_TCE_RHAMNOSE
R_TCE_SER	R_TCE_SER
R_TCE_SINAPYL-ALCOHOL	R_TCE_SINAPYL-ALCOHOL
R_TCE_STEARIC_ACID	R_TCE_STEARIC_ACID
R_TCE_SUC	R_TCE_SUC
R_TCE_SUCROSE	R_TCE_SUCROSE
R_TCE_THF	R_TCE_THF
R_TCE_THIAMINE-PYROPHOSPHATE	R_TCE_THIAMINE-PYROPHOSPHATE
R_TCE_THR	R_TCE_THR
R_TCE_TRP	R_TCE_TRP
R_TCE_TTP	R_TCE_TTP
R_TCE_TYR	R_TCE_TYR
R_TCE_UDP-D-GALACTURONATE	R_TCE_UDP-D-GALACTURONATE
R_TCE_UTP	R_TCE_UTP
R_TCE_VAL	R_TCE_VAL
R_TCE_WATER	R_TCE_WATER
R_TGE_CELLULOSE	R_TGE_CELLULOSE
R_TGE_L-FUCOSE	R_TGE_L-FUCOSE
R_TGE_MANNOSE	R_TGE_MANNOSE
R_TGE_XLFG-Xyloglucans	R_TGE_XLFG-Xyloglucans
R_TGE_XYLOSE	R_TGE_XYLOSE
R_THE_CHLOROPHYLL-A	R_THE_CHLOROPHYLL-A
R_THE_CHLOROPHYLL-B	R_THE_CHLOROPHYLL-B
R_THE_CO-A	R_THE_CO-A
R_THE_CPD1F-114	R_THE_CPD1F-114
R_THE_HEME_O	R_THE_HEME_O
R_THE_Starch	R_THE_Starch
SERCons_tx	SERCons_tx
THRCons_tx	THRCons_tx
TRPCons_tx	TRPCons_tx
TYRCons_tx	TYRCons_tx
VALCons_tx	VALCons_tx
R_TCG_GDP	R_TCG_GDP
R_TCG_GDP-MANNOSE	R_TCG_GDP-MANNOSE
R_TCG_GUANOSINE_DIPHOSPHATE_FUCOSE	R_TCG_GUANOSINE_DIPHOSPHATE_FUCOSE
R_TCG_PROTON	R_TCG_PROTON
R_TCG_UDP	R_TCG_UDP
R_TCG_UDP-D-GALACTURONATE	R_TCG_UDP-D-GALACTURONATE
R_TCG_UDP-D-XYLOSE	R_TCG_UDP-D-XYLOSE
R_TCG_UDP-GALACTOSE	R_TCG_UDP-GALACTOSE
R_TCG_UDP-GLUCOSE	R_TCG_UDP-GLUCOSE
R_TCH_ACP	R_TCH_ACP
R_TCR_ADP	R_TCR_ADP
R_TCR_ALLANTOATE	R_TCR_ALLANTOATE
R_TCR_ATP	R_TCR_ATP
R_TCR_CDP	R_TCR_CDP
R_TCR_CHOLINE	R_TCR_CHOLINE
R_TCR_CO2	R_TCR_CO2
R_TCR_CPD-166	R_TCR_CPD-166
R_TCR_CTP	R_TCR_CTP
R_TCR_DOLICHOLP	R_TCR_DOLICHOLP
R_TCR_FARNESYL-PP	R_TCR_FARNESYL-PP
R_TCR_GLYCEROL-3P	R_TCR_GLYCEROL-3P
R_TCR_Lipid	R_TCR_Lipid
R_TCR_NADH	R_TCR_NADH
R_TCR_NADPH	R_TCR_NADPH
R_TCR_OLEATE-CPD	R_TCR_OLEATE-CPD
R_TCR_OXYGEN	R_TCR_OXYGEN
R_TCR_PALMITYL-COA	R_TCR_PALMITYL-COA
R_TCR_S-ALLANTOIN	R_TCR_S-ALLANTOIN
R_TCR_SAM	R_TCR_SAM
R_TCR_STEAROYL-COA	R_TCR_STEAROYL-COA
R_TCR_WATER	R_TCR_WATER
R_TCR_ZYMOSTEROL	R_TCR_ZYMOSTEROL
R_TCV_CPD-6747	R_TCV_CPD-6747
R_TCV_INOSITOL-1-3-4-TRIPHOSPHATE	R_TCV_INOSITOL-1-3-4-TRIPHOSPHATE
R_TCV_MYO-INOSITOL	R_TCV_MYO-INOSITOL
R_TCX_CO-A	R_TCX_CO-A
R_TCX_CPD-730	R_TCX_CPD-730
R_TCX_CPD-734	R_TCX_CPD-734
R_TCX_DIHYDROXYNAPHTHOATE	R_TCX_DIHYDROXYNAPHTHOATE
R_TCX_O-SUCCINYLBENZOATE	R_TCX_O-SUCCINYLBENZOATE
R_TCX_TRYPTAMINE	R_TCX_TRYPTAMINE
R_TGC_OXYGEN-MOLECULE	R_TGC_OXYGEN-MOLECULE
R_TGC_PECTATE	R_TGC_PECTATE
R_TGC_WATER	R_TGC_WATER
R_THC_10-FORMYL-THF	R_THC_10-FORMYL-THF
R_THC_2KG_MAL	R_THC_2KG_MAL
R_THC_3PGA_Pi	R_THC_3PGA_Pi
R_THC_5-METHYL-THF	R_THC_5-METHYL-THF
R_THC_ACET	R_THC_ACET
R_THC_ACP	R_THC_ACP
R_THC_ADP	R_THC_ADP
R_THC_ADP-D-GLUCOSE_ADP	R_THC_ADP-D-GLUCOSE_ADP
R_THC_ALPHA-D-GALACTOSE	R_THC_ALPHA-D-GALACTOSE
R_THC_AMP	R_THC_AMP
R_THC_ANTHRANILATE	R_THC_ANTHRANILATE
R_THC_ARG	R_THC_ARG
R_THC_ATP	R_THC_ATP
R_THC_ATP_ADP	R_THC_ATP_ADP
R_THC_BILIVERDINE	R_THC_BILIVERDINE
R_THC_CHOLINE	R_THC_CHOLINE
R_THC_CO+2	R_THC_CO+2
R_THC_CO-A	R_THC_CO-A
R_THC_CO2	R_THC_CO2
R_THC_CPD-1099	R_THC_CPD-1099
R_THC_CPD-12815	R_THC_CPD-12815
R_THC_CPD-7279	R_THC_CPD-7279
R_THC_CPD-729	R_THC_CPD-729
R_THC_CPD1F-128	R_THC_CPD1F-128
R_THC_CPD66-34	R_THC_CPD66-34
R_THC_CTP	R_THC_CTP
R_THC_CYS	R_THC_CYS
R_THC_D-RIBULOSE-1-P_Pi	R_THC_D-RIBULOSE-1-P_Pi
R_THC_DELTA3-ISOPENTENYL-PP	R_THC_DELTA3-ISOPENTENYL-PP
R_THC_DEOXX5P_Pi	R_THC_DEOXX5P_Pi
R_THC_DHAP_3PGA	R_THC_DHAP_3PGA
R_THC_DHAP_Pi	R_THC_DHAP_Pi
R_THC_DI-H-OROTATE	R_THC_DI-H-OROTATE
R_THC_FAD	R_THC_FAD
R_THC_FORMATE	R_THC_FORMATE
R_THC_FUM	R_THC_FUM
R_THC_Fe2+	R_THC_Fe2+
R_THC_G6P_Pi	R_THC_G6P_Pi
R_THC_GAP_3PGA	R_THC_GAP_3PGA
R_THC_GAP_Pi	R_THC_GAP_Pi
R_THC_GLC	R_THC_GLC
R_THC_GLT_MAL	R_THC_GLT_MAL
R_THC_GLY	R_THC_GLY
R_THC_GLYCERATE	R_THC_GLYCERATE
R_THC_GLYOX	R_THC_GLYOX
R_THC_GTP	R_THC_GTP
R_THC_Glycolate	R_THC_Glycolate
R_THC_HIS	R_THC_HIS
R_THC_HOMO-CYS	R_THC_HOMO-CYS
R_THC_HOMOGENTISATE	R_THC_HOMOGENTISATE
R_THC_ILE	R_THC_ILE
R_THC_INDOLE_ACETATE_AUXIN	R_THC_INDOLE_ACETATE_AUXIN
R_THC_L-ASPARTATE	R_THC_L-ASPARTATE
R_THC_L-CITRULLINE	R_THC_L-CITRULLINE
R_THC_L-GAMMA-GLUTAMYLCYSTEINE	R_THC_L-GAMMA-GLUTAMYLCYSTEINE
R_THC_LEU	R_THC_LEU
R_THC_LINOLEIC_ACID	R_THC_LINOLEIC_ACID
R_THC_LINOLENIC_ACID	R_THC_LINOLENIC_ACID
R_THC_LYS	R_THC_LYS
R_THC_MALTOSE	R_THC_MALTOSE
R_THC_MET	R_THC_MET
R_THC_METHYLENE-THF	R_THC_METHYLENE-THF
R_THC_MG+2	R_THC_MG+2
R_THC_MTOB	R_THC_MTOB
R_THC_NAD	R_THC_NAD
R_THC_NH3	R_THC_NH3
R_THC_NIACINAMIDE	R_THC_NIACINAMIDE
R_THC_NICOTINATE_NUCLEOTIDE	R_THC_NICOTINATE_NUCLEOTIDE
R_THC_NITRITE	R_THC_NITRITE
R_THC_O-SUCCINYLBENZOATE	R_THC_O-SUCCINYLBENZOATE
R_THC_O2	R_THC_O2
R_THC_OAA_MAL	R_THC_OAA_MAL
R_THC_OLEATE-CPD	R_THC_OLEATE-CPD
R_THC_OROTATE	R_THC_OROTATE
R_THC_P-AMINO-BENZOATE	R_THC_P-AMINO-BENZOATE
R_THC_PALMITATE	R_THC_PALMITATE
R_THC_PAPS	R_THC_PAPS
R_THC_PEP_Pi	R_THC_PEP_Pi
R_THC_PHE	R_THC_PHE
R_THC_PRO	R_THC_PRO
R_THC_PYRUVATE	R_THC_PYRUVATE
R_THC_Pi_H+	R_THC_Pi_H+
R_THC_R-3-hydroxymyristoyl-ACPs	R_THC_R-3-hydroxymyristoyl-ACPs
R_THC_RIBOFLAVIN	R_THC_RIBOFLAVIN
R_THC_SAM_SHAC	R_THC_SAM_SHAC
R_THC_SER	R_THC_SER
R_THC_SO4	R_THC_SO4
R_THC_STEARIC_ACID	R_THC_STEARIC_ACID
R_THC_THF	R_THC_THF
R_THC_THIAMINE	R_THC_THIAMINE
R_THC_THR	R_THC_THR
R_THC_TRP	R_THC_TRP
R_THC_TYR	R_THC_TYR
R_THC_UTP	R_THC_UTP
R_THC_VAL	R_THC_VAL
R_THC_WATER	R_THC_WATER
R_THC_X5P_Pi	R_THC_X5P_Pi
R_TMC_2KG_ACONITATE	R_TMC_2KG_ACONITATE
R_TMC_2KG_CIT	R_TMC_2KG_CIT
R_TMC_2KG_ISOCITRATE	R_TMC_2KG_ISOCITRATE
R_TMC_2KG_MAL	R_TMC_2KG_MAL
R_TMC_2KG_OAA	R_TMC_2KG_OAA
R_TMC_2KG_SUC	R_TMC_2KG_SUC
R_TMC_3-HYDROXY-PROPIONATE	R_TMC_3-HYDROXY-PROPIONATE
R_TMC_4-AMINO-BUTYRATE	R_TMC_4-AMINO-BUTYRATE
R_TMC_ACET	R_TMC_ACET
R_TMC_ACETALD	R_TMC_ACETALD
R_TMC_AMINO-OH-HYDROXYMETHYL-DIHYDROPTERIDINE	R_TMC_AMINO-OH-HYDROXYMETHYL-DIHYDROPTERIDINE
R_TMC_ARG	R_TMC_ARG
R_TMC_ARG_CITRULLINE	R_TMC_ARG_CITRULLINE
R_TMC_ARG_HIS	R_TMC_ARG_HIS
R_TMC_ARG_LYS	R_TMC_ARG_LYS
R_TMC_ARG_ORNITHINE	R_TMC_ARG_ORNITHINE
R_TMC_ASCORBATE_CPD-330	R_TMC_ASCORBATE_CPD-330
R_TMC_ATP_ADP	R_TMC_ATP_ADP
R_TMC_ATP_AMP	R_TMC_ATP_AMP
R_TMC_CIT_ACONITATE	R_TMC_CIT_ACONITATE
R_TMC_CIT_ISOCITRATE	R_TMC_CIT_ISOCITRATE
R_TMC_CO-A	R_TMC_CO-A
R_TMC_CO2	R_TMC_CO2
R_TMC_CYS	R_TMC_CYS
R_TMC_DUMP	R_TMC_DUMP
R_TMC_FORMATE	R_TMC_FORMATE
R_TMC_GLN	R_TMC_GLN
R_TMC_GLY	R_TMC_GLY
R_TMC_HIS_CITRULLINE	R_TMC_HIS_CITRULLINE
R_TMC_HIS_ORNITHINE	R_TMC_HIS_ORNITHINE
R_TMC_HS	R_TMC_HS
R_TMC_ILE	R_TMC_ILE
R_TMC_ISOCITRATE_ACONITATE	R_TMC_ISOCITRATE_ACONITATE
R_TMC_L-ASPARTATE	R_TMC_L-ASPARTATE
R_TMC_L-PANTOATE	R_TMC_L-PANTOATE
R_TMC_LEU	R_TMC_LEU
R_TMC_LYS_CITRULLINE	R_TMC_LYS_CITRULLINE
R_TMC_LYS_HIS	R_TMC_LYS_HIS
R_TMC_LYS_ORNITHINE	R_TMC_LYS_ORNITHINE
R_TMC_MAL_ACONITATE	R_TMC_MAL_ACONITATE
R_TMC_MAL_CIT	R_TMC_MAL_CIT
R_TMC_MAL_ISOCITRATE	R_TMC_MAL_ISOCITRATE
R_TMC_MAL_Pi	R_TMC_MAL_Pi
R_TMC_MAL_SO4	R_TMC_MAL_SO4
R_TMC_MAL_SUC	R_TMC_MAL_SUC
R_TMC_METHYLENE-THF	R_TMC_METHYLENE-THF
R_TMC_NH3	R_TMC_NH3
R_TMC_O2	R_TMC_O2
R_TMC_OAA_ACONITATE	R_TMC_OAA_ACONITATE
R_TMC_OAA_CIT	R_TMC_OAA_CIT
R_TMC_OAA_ISOCITRATE	R_TMC_OAA_ISOCITRATE
R_TMC_OAA_MAL	R_TMC_OAA_MAL
R_TMC_OAA_Pi	R_TMC_OAA_Pi
R_TMC_OAA_SO4	R_TMC_OAA_SO4
R_TMC_OAA_SUC	R_TMC_OAA_SUC
R_TMC_ORNITHINE_CITRULLINE	R_TMC_ORNITHINE_CITRULLINE
R_TMC_P-AMINO-BENZOATE	R_TMC_P-AMINO-BENZOATE
R_TMC_PPI	R_TMC_PPI
R_TMC_PRO	R_TMC_PRO
R_TMC_PROTOPORPHYRINOGEN	R_TMC_PROTOPORPHYRINOGEN
R_TMC_PROTOPORPHYRIN_IX	R_TMC_PROTOPORPHYRIN_IX
R_TMC_PYRUVATE_H+	R_TMC_PYRUVATE_H+
R_TMC_Pi_H+	R_TMC_Pi_H+
R_TMC_SER	R_TMC_SER
R_TMC_SUC_ACONITATE	R_TMC_SUC_ACONITATE
R_TMC_SUC_CIT	R_TMC_SUC_CIT
R_TMC_SUC_FUM	R_TMC_SUC_FUM
R_TMC_SUC_ISOCITRATE	R_TMC_SUC_ISOCITRATE
R_TMC_SUC_Pi	R_TMC_SUC_Pi
R_TMC_SUC_SO4	R_TMC_SUC_SO4
R_TMC_THF	R_TMC_THF
R_TMC_TMP	R_TMC_TMP
R_TMC_UREA	R_TMC_UREA
R_TMC_VAL	R_TMC_VAL
R_TMC_WATER	R_TMC_WATER
R_TRC_CPD1F-128	R_TRC_CPD1F-128
R_TRC_CPD1F-95	R_TRC_CPD1F-95
R_TRC_PPI	R_TRC_PPI
R_TRC_PhosphatidylCholine	R_TRC_PhosphatidylCholine
R_TRC_Pi	R_TRC_Pi
R_TVC_2-KETOGLUTARATE	R_TVC_2-KETOGLUTARATE
R_TVC_AMMONIA	R_TVC_AMMONIA
R_TVC_CIT	R_TVC_CIT
R_TVC_CPD-506	R_TVC_CPD-506
R_TVC_FUM	R_TVC_FUM
R_TVC_INOSITOL_PROTON	R_TVC_INOSITOL_PROTON
R_TVC_L-ALPHA-ALANINE	R_TVC_L-ALPHA-ALANINE
R_TVC_MAL	R_TVC_MAL
R_TVC_MI-HEXAKISPHOSPHATE	R_TVC_MI-HEXAKISPHOSPHATE
R_TVC_PROTON_GLC	R_TVC_PROTON_GLC
R_TVC_PROTON_NITRATE	R_TVC_PROTON_NITRATE
R_TVC_Phosphatidyl-4-5-MyoInositol	R_TVC_Phosphatidyl-4-5-MyoInositol
R_TVC_Pi	R_TVC_Pi
R_TVC_SUC	R_TVC_SUC
R_TVC_SUCROSE_PROTON	R_TVC_SUCROSE_PROTON
R_TVC_SUCROSE_rev	R_TVC_SUCROSE_rev
R_TVC_SULFATE	R_TVC_SULFATE
R_TVC_SULFATE_PROTON	R_TVC_SULFATE_PROTON
R_TVC_THREO-DS-ISO-CITRATE	R_TVC_THREO-DS-ISO-CITRATE
R_TVC_UREA	R_TVC_UREA
R_TXC_2-KETOGLUTARATE	R_TXC_2-KETOGLUTARATE
R_TXC_ACET	R_TXC_ACET
R_TXC_AMP_ATP	R_TXC_AMP_ATP
R_TXC_ATP_ADP	R_TXC_ATP_ADP
R_TXC_CIT	R_TXC_CIT
R_TXC_CO2	R_TXC_CO2
R_TXC_CPD-4211	R_TXC_CPD-4211
R_TXC_CPD-499	R_TXC_CPD-499
R_TXC_DELTA3-ISOPENTENYL-PP	R_TXC_DELTA3-ISOPENTENYL-PP
R_TXC_GLT	R_TXC_GLT
R_TXC_GLY	R_TXC_GLY
R_TXC_GLYCERATE	R_TXC_GLYCERATE
R_TXC_GLYOX	R_TXC_GLYOX
R_TXC_Glycolate	R_TXC_Glycolate
R_TXC_INDOLE_ACETATE_AUXIN	R_TXC_INDOLE_ACETATE_AUXIN
R_TXC_L-ASPARTATE	R_TXC_L-ASPARTATE
R_TXC_MAL	R_TXC_MAL
R_TXC_NH3	R_TXC_NH3
R_TXC_O2	R_TXC_O2
R_TXC_OAA	R_TXC_OAA
R_TXC_PALMITATE	R_TXC_PALMITATE
R_TXC_PPi	R_TXC_PPi
R_TXC_Pi	R_TXC_Pi
R_TXC_S-ALLANTOIN	R_TXC_S-ALLANTOIN
R_TXC_SER	R_TXC_SER
R_TXC_SO3	R_TXC_SO3
R_TXC_SO4	R_TXC_SO4
R_TXC_SUC	R_TXC_SUC
R_TXC_THREO-DS-ISO-CITRATE	R_TXC_THREO-DS-ISO-CITRATE
R_TXC_URATE	R_TXC_URATE
1.1.1.264-RXN-(NADP)_C	<small>L</small>-idonate 5-dehydrogenase
1.14.13.87-RXN-(NAD)_C	licodione synthase
1.14.13.87-RXN-(NADP)_C	licodione synthase
2.1.1.162-RXN_C	glycine/sarcosine/dimethylglycine <em>N</em>-methyltransferase
6PGLUCONDEHYDROG-RXN-(NADP)_C	Phosphogluconate dehydrogenase (decarboxylating)
ESTRADIOL-17-BETA-DEHYDROGENASE-RXN-(NAD)_C	estradiol 17&beta;-dehydrogenase
ESTRADIOL-17-BETA-DEHYDROGENASE-RXN-(NADP)_C	estradiol 17&beta;-dehydrogenase
GLC6PISOM1_C	Glucose-6-P Isomerase
GLC6PISOM2_C	Glucose 6 phosphate isomerase
GLUCOSE-1-DEHYDROGENASE-RXN-(NAD)_C	glucose 1-dehydrogenase
GLUCOSE-1-DEHYDROGENASE-RXN-(NADP)_C	glucose 1-dehydrogenase
HOMOSERDEHYDROG-RXN-(NAD)_C	homoserine dehydrogenase
HOMOSERDEHYDROG-RXN-(NADP)_C	homoserine dehydrogenase
NADPH-DEHYDROGENASE-QUINONE-RXN_C	NADPH dehydrogenase (quinone)
NADP_NAD_C	NADP_NAD
NQOR-RXN-(NAD)_C	NAD(P)H dehydrogenase (quinone)
NQOR-RXN-(NADP)_C	NAD(P)H dehydrogenase (quinone)
PYRROLINECARBREDUCT-RXN-(NAD)_C	pyrroline-5-carboxylate reductase
PYRROLINECARBREDUCT-RXN-(NADP)_C	pyrroline-5-carboxylate reductase
RXN-10745-(NAD)_C	NAD(P)H oxidase
RXN-10745-(NADP)_C	NAD(P)H oxidase
RXN-10813-(NADP)_C	malate dehydrogenase [NAD(P)<small><sup>+</sup></small>]
RXN-11362-(NAD)_C	molybdopterin synthase sulfurtransferase
RXN-11362-(NADP)_C	molybdopterin synthase sulfurtransferase
RXN-12303-(NAD)_C	NAD(P)H dehydrogenase (plastoquinone)
RXN-12303-(NADP)_C	NAD(P)H dehydrogenase (plastoquinone)
RXN-12473-(NAD)_C	molybdopterin synthase sulfurtransferase
RXN-12473-(NADP)_C	molybdopterin synthase sulfurtransferase
RXN-6903-(NAD)_C	RXN-6903
RXN-6903-(NADP)_C	RXN-6903
RXN-7221_C	RXN-7221
RXN-7222_C	RXN-7222
RXN-7223_C	RXN-7223
RXN-7622-(NAD)_C	RXN-7622
RXN-7622-(NADP)_C	RXN-7622
RXN-7678-(NAD)_C	chlorophyll(ide) <em>b</em> reductase
RXN-7678-(NADP)_C	chlorophyll(ide) <em>b</em> reductase
RXN-7968-(NAD)_C	quinate/shikimate dehydrogenase
RXN-9290-(NAD)_C	momilactone-A synthase
RXN-9290-(NADP)_C	momilactone-A synthase
RXN-9703-(NAD)_C	RXN-9703
RXN-9703-(NADP)_C	RXN-9703
RXN2GG-5260_C	RXN2GG-5260
RXN2GG-5261_C	RXN2GG-5261
RXN2GG-5293_C	RXN2GG-5293
RXN2GG-5323_C	RXN2GG-5323
RXN2GG-5324_C	RXN2GG-5324
RXN2GG-5325_C	RXN2GG-5325
RXN2GG-5327_C	RXN2GG-5327
RXN2GG-5418_C	RXN2GG-5418
RXN2GG-5419_C	RXN2GG-5419
RXN2GG-5420_C	RXN2GG-5420
RXN2GG-5421_C	RXN2GG-5421
RXNDLN-13_C	Instance of Methionine transaminase
RXNDLN-14_C	RXNDLN-14
RXNDLN-15_C	Ribulose phosphate dephosphatase
RXNDLN-17_C	Lipid-Linolenate Dissociation reaction
RXNDLN-18_C	Linoleoyl Lipid Dissociation Reaction
RXNDLN-19_C	RXNDLN-19
RXNDLN-20_C	RXNDLN-20
RXNDLN-21_C	Dissassociation Fucose from GDP
RXNDLN-22_C	RXNDLN-22
RXNDLN-24_C	RXNDLN-24
RXNDLN-27_C	RXNDLN-27
RXNDLN-30_C	RXNDLN-30
RXNDLN-32_C	RXNDLN-32
RXNDLN-40_C	RXNDLN-40
RXNDLN-5_C	RXNDLN-5
RXNDLN-6_C	Glutamyltransferase
NADP_NAD_G	NADP_NAD
RXNDLN-35_G	Pectate-Conversion
6PGLUCONDEHYDROG-RXN-(NADP)_H	Phosphogluconate dehydrogenase (decarboxylating)
CyclicElectronFlow_H	CyclicElectronFlow
DIHYDROPICRED-RXN-(NAD)_H	dihydrodipicolinate reductase
DIHYDROPICRED-RXN-(NADP)_H	dihydrodipicolinate reductase
GLC6PIsom1_H	GLC6PIsom1
GLC6PIsom2_H	GLC6PIsom2
GLUTAMATE-DEHYDROGENASE-NADP+-RXN-(NAD)_H	glutamate dehydrogenase [NAD(P)<small><sup>+</sup></small>]
GLUTAMATE-DEHYDROGENASE-NADP+-RXN-(NADP)_H	glutamate dehydrogenase [NAD(P)<small><sup>+</sup></small>]
GLYC3PDEHYDROGBIOSYN-RXN-(NADP)_H	glycerol-3-phosphate dehydrogenase [NAD(P)<small><sup>+</sup></small>]
HOMOSERDEHYDROG-RXN-(NAD)_H	homoserine dehydrogenase
HOMOSERDEHYDROG-RXN-(NADP)_H	homoserine dehydrogenase
ISPH2-RXN-(NAD)_H	4-hydroxy-3-methylbut-2-enyl diphosphate reductase
ISPH2-RXN-(NADP)_H	4-hydroxy-3-methylbut-2-enyl diphosphate reductase
LumenToStromaFerredox_H	LumenToStromaFerredox
NADP_NAD_H	NADP_NAD
NQOR-RXN-(NAD)_H	NAD(P)H dehydrogenase (quinone)
NQOR-RXN-(NADP)_H	NAD(P)H dehydrogenase (quinone)
PYRROLINECARBREDUCT-RXN-(NAD)_H	pyrroline-5-carboxylate reductase
PYRROLINECARBREDUCT-RXN-(NADP)_H	pyrroline-5-carboxylate reductase
RXN-10813-(NADP)_H	malate dehydrogenase [NAD(P)<small><sup>+</sup></small>]
RXN-11632-(NADP)_H	1-pyrroline-5-carboxylate dehydrogenase
RXN-12303-(NAD)_H	NAD(P)H dehydrogenase (plastoquinone)
RXN-12303-(NADP)_H	NAD(P)H dehydrogenase (plastoquinone)
RXN-7622-(NAD)_H	RXN-7622
RXN-7622-(NADP)_H	RXN-7622
RXN-7678-(NAD)_H	chlorophyll(ide) <em>b</em> reductase
RXN-7678-(NADP)_H	chlorophyll(ide) <em>b</em> reductase
RXN-7978-(NAD)_H	zeaxanthin epoxidase
RXN-7978-(NADP)_H	zeaxanthin epoxidase
RXN-7979-(NAD)_H	zeaxanthin epoxidase
RXN-7979-(NADP)_H	zeaxanthin epoxidase
RXN0-884-(NAD)_H	4-hydroxy-3-methylbut-2-enyl diphosphate reductase
RXN0-884-(NADP)_H	4-hydroxy-3-methylbut-2-enyl diphosphate reductase
RXNDLN-13_H	Instance of Methionine transaminase
RXNDLN-17_H	Lipid-Linolenate Dissociation reaction
RXNDLN-18_H	Linoleoyl Lipid Dissociation Reaction
RXNDLN-26_H	RXNDLN-26
RXNDLN-29_H	RXNDLN-29
RXNDLN-38_H	Disproportioning Enzyme Reaction
RXNDLN-39_H	Amylase
RXNDLN-4_H	RXNDLN-4
RXNDLN-5_H	RXNDLN-5
6PGLUCONDEHYDROG-RXN-(NADP)_M	Phosphogluconate dehydrogenase (decarboxylating)
GLUTAMATE-DEHYDROGENASE-NADP+-RXN-(NAD)_M	glutamate dehydrogenase [NAD(P)<small><sup>+</sup></small>]
GLUTAMATE-DEHYDROGENASE-NADP+-RXN-(NADP)_M	glutamate dehydrogenase [NAD(P)<small><sup>+</sup></small>]
GLYC3PDEHYDROGBIOSYN-RXN-(NADP)_M	glycerol-3-phosphate dehydrogenase [NAD(P)<small><sup>+</sup></small>]
NADP_NAD_M	NADP_NAD
NQOR-RXN-(NAD)_M	NAD(P)H dehydrogenase (quinone)
NQOR-RXN-(NADP)_M	NAD(P)H dehydrogenase (quinone)
RXN-10813-(NADP)_M	malate dehydrogenase [NAD(P)<small><sup>+</sup></small>]
RXN-11632-(NADP)_M	1-pyrroline-5-carboxylate dehydrogenase
RXN-12303-(NAD)_M	NAD(P)H dehydrogenase (plastoquinone)
RXN-12303-(NADP)_M	NAD(P)H dehydrogenase (plastoquinone)
RXN-9290-(NAD)_M	momilactone-A synthase
RXN-9290-(NADP)_M	momilactone-A synthase
RXNDLN-13_M	Instance of Methionine transaminase
RXNDLN-22-(NAD)_M	RXNDLN-22
RXNDLN-26_M	RXNDLN-26
RXNDLN-4_M	RXNDLN-4
1.14.21.6-RXN-(NAD)_R	lathosterol oxidase
1.14.21.6-RXN-(NADP)_R	lathosterol oxidase
ESTRADIOL-17-BETA-DEHYDROGENASE-RXN-(NAD)_R	estradiol 17&beta;-dehydrogenase
ESTRADIOL-17-BETA-DEHYDROGENASE-RXN-(NADP)_R	estradiol 17&beta;-dehydrogenase
NADP_NAD_R	NADP_NAD
RXN66-26-(NAD)_R	RXN66-26
RXN66-26-(NADP)_R	RXN66-26
RXN66-310-(NAD)_R	RXN66-310
RXN66-310-(NADP)_R	RXN66-310
RXN66-311-(NAD)_R	RXN66-311
RXN66-311-(NADP)_R	RXN66-311
RXN66-312-(NAD)_R	RXN66-312
RXN66-312-(NADP)_R	RXN66-312
RXN66-313-(NAD)_R	RXN66-313
RXN66-313-(NADP)_R	RXN66-313
RXN66-315-(NAD)_R	RXN66-315
RXN66-315-(NADP)_R	RXN66-315
RXN66-316-(NAD)_R	RXN66-316
RXN66-316-(NADP)_R	RXN66-316
RXN66-317-(NAD)_R	RXN66-317
RXN66-317-(NADP)_R	RXN66-317
RXN66-318-(NAD)_R	RXN66-318
RXN66-318-(NADP)_R	RXN66-318
RXNDLN-22_R	RXNDLN-22
RXNDLN-4_R	RXNDLN-4
RXNDLN-5_R	RXNDLN-5
GLUTAMATE-DEHYDROGENASE-NADP+-RXN-(NAD)_V	glutamate dehydrogenase [NAD(P)<small><sup>+</sup></small>]
GLUTAMATE-DEHYDROGENASE-NADP+-RXN-(NADP)_V	glutamate dehydrogenase [NAD(P)<small><sup>+</sup></small>]
NADP_NAD_V	NADP_NAD
NQOR-RXN-(NAD)_V	NAD(P)H dehydrogenase (quinone)
NQOR-RXN-(NADP)_V	NAD(P)H dehydrogenase (quinone)
RXN-10813-(NADP)_V	malate dehydrogenase [NAD(P)<small><sup>+</sup></small>]
RXN-12303-(NAD)_V	NAD(P)H dehydrogenase (plastoquinone)
RXN-12303-(NADP)_V	NAD(P)H dehydrogenase (plastoquinone)
6PGLUCONDEHYDROG-RXN-(NADP)_X	Phosphogluconate dehydrogenase (decarboxylating)
Butyryl-Oxidation_X	Butyryl-Oxidation
Decanoyl-Oxidation_X	Decanoyl-Oxidation
Hexanoyl-Oxidation_X	Hexanoyl-Oxidation
Lauroyl-Oxidation_X	Lauroyl-Oxidation
NADP_NAD_X	NADP_NAD
Octanoyl-Oxidation_X	Octanoyl-Oxidation
PALMITATE-COA-SYNTHASE-RXN_X	PALMITATE-COA-SYNTHASE-RXN
Palmitoyl-Oxidation_X	Palmitoyl-Oxidation
RXN-10813-(NADP)_X	malate dehydrogenase [NAD(P)<small><sup>+</sup></small>]
RXN-7712-(NAD)_X	RXN-7712
RXN-7712-(NADP)_X	RXN-7712
STEARATE-COA-SYNTHASE-RXN_X	STEARATE-COA-SYNTHASE-RXN
Steaoryl-Oxidation_X	Steaoryl-Oxidation
Tetradecaoyl-Oxidation_X	Tetradecaoyl-Oxidation
DEHOG	DEHOG
BiomassShoot	BiomassShoot
BiomassRoot	BiomassRoot
BiomassWithOutStarch	BiomassWithOutStarch
