R_1.1.1.170-RXN-NADP_c_COT	1.1.1.170-RXN
R_1.1.1.170-RXN-NADP_c_HRA	1.1.1.170-RXN
R_1.1.1.170-RXN-NAD_c_COT	1.1.1.170-RXN
R_1.1.1.170-RXN-NAD_c_HRA	1.1.1.170-RXN
R_1.1.1.222-RXN-NADP_c_COT	1.1.1.222-RXN
R_1.1.1.222-RXN-NADP_c_HRA	1.1.1.222-RXN
R_1.1.1.222-RXN-NAD_c_COT	1.1.1.222-RXN
R_1.1.1.222-RXN-NAD_c_HRA	1.1.1.222-RXN
R_1.1.1.285-RXN-NADP_c_COT	1.1.1.285-RXN
R_1.1.1.285-RXN-NADP_c_HRA	1.1.1.285-RXN
R_1.1.1.285-RXN-NAD_c_COT	1.1.1.285-RXN
R_1.1.1.285-RXN-NAD_c_HRA	1.1.1.285-RXN
R_1.1.1.51-RXN-NADP_c_COT	1.1.1.51-RXN
R_1.1.1.51-RXN-NADP_c_HRA	1.1.1.51-RXN
R_1.1.1.51-RXN-NAD_c_COT	1.1.1.51-RXN
R_1.1.1.51-RXN-NAD_c_HRA	1.1.1.51-RXN
R_1.14.13.72-RXN-NADP_c_COT	methylsterol monooxygenase
R_1.14.13.72-RXN-NADP_c_HRA	methylsterol monooxygenase
R_1.14.13.72-RXN-NAD_c_COT	methylsterol monooxygenase
R_1.14.13.72-RXN-NAD_c_HRA	methylsterol monooxygenase
R_1.14.13.87-RXN-NADP_c_COT	1.14.13.87-RXN
R_1.14.13.87-RXN-NADP_c_HRA	1.14.13.87-RXN
R_1.14.13.87-RXN-NAD_c_COT	1.14.13.87-RXN
R_1.14.13.87-RXN-NAD_c_HRA	1.14.13.87-RXN
R_1.14.21.6-RXN-NADP_c_COT	1.14.21.6-RXN
R_1.14.21.6-RXN-NADP_c_HRA	1.14.21.6-RXN
R_1.14.21.6-RXN-NAD_c_COT	1.14.21.6-RXN
R_1.14.21.6-RXN-NAD_c_HRA	1.14.21.6-RXN
R_1.14.99.33-RXN-NADP_c_COT	1.14.99.33-RXN
R_1.14.99.33-RXN-NADP_c_HRA	1.14.99.33-RXN
R_1.14.99.33-RXN-NAD_c_COT	1.14.99.33-RXN
R_1.14.99.33-RXN-NAD_c_HRA	1.14.99.33-RXN
R_1.2.7.1-Pyruvic-ferredoxin-oxidoredutase_m_COT	1.2.7.1-Pyruvic-ferredoxin-oxidoredutase
R_1.2.7.1-Pyruvic-ferredoxin-oxidoredutase_m_HRA	1.2.7.1-Pyruvic-ferredoxin-oxidoredutase
R_1.5.1.25-RXN-NADP_c_COT	1.5.1.25-RXN
R_1.5.1.25-RXN-NADP_c_HRA	1.5.1.25-RXN
R_1.5.1.25-RXN-NAD_c_COT	1.5.1.25-RXN
R_1.5.1.25-RXN-NAD_c_HRA	1.5.1.25-RXN
R_10-FORMYL-THF_pc_COT	R_10-FORMYL-THF_pc_COT
R_10-FORMYL-THF_pc_HRA	R_10-FORMYL-THF_pc_HRA
R_2-KETOGLUTARATE_xc_COT	R_2-KETOGLUTARATE_xc_COT
R_2-KETOGLUTARATE_xc_HRA	R_2-KETOGLUTARATE_xc_HRA
R_2-MEBUCOA-ETF-RXN_m_COT	2-MEBUCOA-ETF-RXN
R_2-MEBUCOA-ETF-RXN_m_HRA	2-MEBUCOA-ETF-RXN
R_2KETOBUTYRYL-TRANS_mc_COT	2KETOBUTYRYL-TRANS
R_2KETOBUTYRYL-TRANS_mc_HRA	2KETOBUTYRYL-TRANS
R_2KG-2K-ADIPATE_mc_COT	R_2KG-2K-ADIPATE_mc_COT
R_2KG-2K-ADIPATE_mc_HRA	R_2KG-2K-ADIPATE_mc_HRA
R_2KG_ACONITATE_mc_COT	R_2KG_ACONITATE_mc_COT
R_2KG_ACONITATE_mc_HRA	R_2KG_ACONITATE_mc_HRA
R_2KG_CIT_mc_COT	R_2KG_CIT_mc_COT
R_2KG_CIT_mc_HRA	R_2KG_CIT_mc_HRA
R_2KG_ISOCITRATE_mc_COT	R_2KG_ISOCITRATE_mc_COT
R_2KG_ISOCITRATE_mc_HRA	R_2KG_ISOCITRATE_mc_HRA
R_2KG_MAL_mc_COT	R_2KG_MAL_mc_COT
R_2KG_MAL_mc_HRA	R_2KG_MAL_mc_HRA
R_2KG_MAL_pc_COT	R_2KG_MAL_pc_COT
R_2KG_MAL_pc_HRA	R_2KG_MAL_pc_HRA
R_2KG_OAA_mc_COT	R_2KG_OAA_mc_COT
R_2KG_OAA_mc_HRA	R_2KG_OAA_mc_HRA
R_2KG_SUC_mc_COT	R_2KG_SUC_mc_COT
R_2KG_SUC_mc_HRA	R_2KG_SUC_mc_HRA
R_2OXOBUT-TRANS_mc_COT	2OXOBUT-TRANS
R_2OXOBUT-TRANS_mc_HRA	2OXOBUT-TRANS
R_2OXOBUT-TRANS_pc_COT	2OXOBUT-TRANS
R_2OXOBUT-TRANS_pc_HRA	2OXOBUT-TRANS
R_2PHENYLETHANOL_biomass_COT	R_2PHENYLETHANOL_biomass_COT
R_2PHENYLETHANOL_biomass_HRA	R_2PHENYLETHANOL_biomass_HRA
R_3-HYDROXY-PROPIONATE_mc_COT	R_3-HYDROXY-PROPIONATE_mc_COT
R_3-HYDROXY-PROPIONATE_mc_HRA	R_3-HYDROXY-PROPIONATE_mc_HRA
R_3PGA_Pi_pc_COT	R_3PGA_Pi_pc_COT
R_3PGA_Pi_pc_HRA	R_3PGA_Pi_pc_HRA
R_4-AMINO-BUTYRATE_mc_COT	R_4-AMINO-BUTYRATE_mc_COT
R_4-AMINO-BUTYRATE_mc_HRA	R_4-AMINO-BUTYRATE_mc_HRA
R_4-Amino-Butyrate-Trans-PHL	R_4-Amino-Butyrate-Trans-PHL
R_5-METHYL-THF_pc_COT	R_5-METHYL-THF_pc_COT
R_5-METHYL-THF_pc_HRA	R_5-METHYL-THF_pc_HRA
R_ACETALD_mc_COT	R_ACETALD_mc_COT
R_ACETALD_mc_HRA	R_ACETALD_mc_HRA
R_ACET_mc_COT	R_ACET_mc_COT
R_ACET_mc_HRA	R_ACET_mc_HRA
R_ACET_pc_COT	R_ACET_pc_COT
R_ACET_pc_HRA	R_ACET_pc_HRA
R_ACET_xc_COT	R_ACET_xc_COT
R_ACET_xc_HRA	R_ACET_xc_HRA
R_ACRYLYL-COA_mc_COT	R_ACRYLYL-COA_mc_COT
R_ACRYLYL-COA_mc_HRA	R_ACRYLYL-COA_mc_HRA
R_ACRYLYL-COA_xc_COT	R_ACRYLYL-COA_xc_COT
R_ACRYLYL-COA_xc_HRA	R_ACRYLYL-COA_xc_HRA
R_ACTCOA_m_COT	ACTCOA
R_ACTCOA_m_HRA	ACTCOA
R_ADP_pc_COT	R_ADP_pc_COT
R_ADP_pc_HRA	R_ADP_pc_HRA
R_AMINO-OH-HYDROXYMETHYL-DIHYDROPTERIDINE_mc_COT	R_AMINO-OH-HYDROXYMETHYL-DIHYDROPTERIDINE_mc_COT
R_AMINO-OH-HYDROXYMETHYL-DIHYDROPTERIDINE_mc_HRA	R_AMINO-OH-HYDROXYMETHYL-DIHYDROPTERIDINE_mc_HRA
R_AMMONIA_vc_COT	R_AMMONIA_vc_COT
R_AMMONIA_vc_HRA	R_AMMONIA_vc_HRA
R_AMP_ATP_xc_COT	R_AMP_ATP_xc_COT
R_AMP_ATP_xc_HRA	R_AMP_ATP_xc_HRA
R_AMP_biomass_COT	R_AMP_biomass_COT
R_AMP_biomass_HRA	R_AMP_biomass_HRA
R_AMP_pc_COT	R_AMP_pc_COT
R_AMP_pc_HRA	R_AMP_pc_HRA
R_ARABINOSE_biomass_COT	R_ARABINOSE_biomass_COT
R_ARABINOSE_biomass_HRA	R_ARABINOSE_biomass_HRA
R_ARACHIDIC_ACID_xc_COT	ARACHIDIC
R_ARACHIDIC_ACID_xc_HRA	ARACHIDIC
R_ARG_CITRULLINE_mc_COT	R_ARG_CITRULLINE_mc_COT
R_ARG_CITRULLINE_mc_HRA	R_ARG_CITRULLINE_mc_HRA
R_ARG_HIS_mc_COT	R_ARG_HIS_mc_COT
R_ARG_HIS_mc_HRA	R_ARG_HIS_mc_HRA
R_ARG_LYS_mc_COT	R_ARG_LYS_mc_COT
R_ARG_LYS_mc_HRA	R_ARG_LYS_mc_HRA
R_ARG_ORNITHINE_mc_COT	R_ARG_ORNITHINE_mc_COT
R_ARG_ORNITHINE_mc_HRA	R_ARG_ORNITHINE_mc_HRA
R_ARG_mc_COT	R_ARG_mc_COT
R_ARG_mc_HRA	R_ARG_mc_HRA
R_ASCORBATE_CPD-330_mc_COT	R_ASCORBATE_CPD-330_mc_COT
R_ASCORBATE_CPD-330_mc_HRA	R_ASCORBATE_CPD-330_mc_HRA
R_ASCORBATE_biomass_COT	R_ASCORBATE_biomass_COT
R_ASCORBATE_biomass_HRA	R_ASCORBATE_biomass_HRA
R_ATP_ADP_Pi_pc_COT	R_ATP_ADP_Pi_pc_COT
R_ATP_ADP_Pi_pc_HRA	R_ATP_ADP_Pi_pc_HRA
R_ATP_ADP_mc_COT	R_ATP_ADP_mc_COT
R_ATP_ADP_mc_HRA	R_ATP_ADP_mc_HRA
R_ATP_ADP_xc_COT	R_ATP_ADP_xc_COT
R_ATP_ADP_xc_HRA	R_ATP_ADP_xc_HRA
R_ATP_AMP_mc_COT	R_ATP_AMP_mc_COT
R_ATP_AMP_mc_HRA	R_ATP_AMP_mc_HRA
R_ATP_pc_COT	R_ATP_pc_COT
R_ATP_pc_HRA	R_ATP_pc_HRA
R_Acyl-CoA-oxidase_x_COT	R_Acyl-CoA-oxidase_x_COT
R_Acyl-CoA-oxidase_x_HRA	R_Acyl-CoA-oxidase_x_HRA
R_Alanine-Trans-PHL	R_Alanine-Trans-PHL
R_Alpha-Linolenate_ACT_x_COT	Alpha-Linolenate_ACT
R_Alpha-Linolenate_ACT_x_HRA	Alpha-Linolenate_ACT
R_Alpha-Linolenate_pc_COT	Alpha-Linolenate
R_Alpha-Linolenate_pc_HRA	Alpha-Linolenate
R_Alpha-Linolenoyl-ACP-hydrolase_p_COT	Alpha-Linolenoyl-ACP-hydrolase
R_Alpha-Linolenoyl-ACP-hydrolase_p_HRA	Alpha-Linolenoyl-ACP-hydrolase
R_Arachidate_ACT_x_COT	Arachidate_ACT
R_Arachidate_ACT_x_HRA	Arachidate_ACT
R_Arachidate_biomass_COT	R_Arachidate_biomass_COT
R_Arachidate_biomass_HRA	R_Arachidate_biomass_HRA
R_Arachidoyl-COA-HYDROLASE-RXN_c_COT	Arachidoyl-COA-HYDROLASE-RXN
R_Arachidoyl-COA-HYDROLASE-RXN_c_HRA	Arachidoyl-COA-HYDROLASE-RXN
R_Arachidoyl-CoA_oxi_x_COT	Arachidoyl-CoA_oxi
R_Arachidoyl-CoA_oxi_x_HRA	Arachidoyl-CoA_oxi
R_Arginine-Trans-PHL	R_Arginine-Trans-PHL
R_Asparagine-Trans-PHL	R_Asparagine-Trans-PHL
R_Aspartate-Trans-PHL	R_Aspartate-Trans-PHL
R_BILIVERDIN-REDUCTASE-RXN-NADP_c_COT	BILIVERDIN-REDUCTASE-RXN
R_BILIVERDIN-REDUCTASE-RXN-NADP_c_HRA	BILIVERDIN-REDUCTASE-RXN
R_BILIVERDIN-REDUCTASE-RXN-NAD_c_COT	BILIVERDIN-REDUCTASE-RXN
R_BILIVERDIN-REDUCTASE-RXN-NAD_c_HRA	BILIVERDIN-REDUCTASE-RXN
R_Beta_Oxidation_x_COT	Beta_Oxidation
R_Beta_Oxidation_x_HRA	Beta_Oxidation
R_CA+2_rev_vc_COT	R_CA+2_rev_vc_COT
R_CA+2_rev_vc_HRA	R_CA+2_rev_vc_HRA
R_CELLWALL-HYDROLYSIS_c_COT	R_CELLWALL-HYDROLYSIS_c_COT
R_CELLWALL-HYDROLYSIS_c_HRA	R_CELLWALL-HYDROLYSIS_c_HRA
R_CELLWALL-SYNTHESIS_c_COT	R_CELLWALL-SYNTHESIS_c_COT
R_CELLWALL-SYNTHESIS_c_HRA	R_CELLWALL-SYNTHESIS_c_HRA
R_CHLOROPHYLL-A_biomass_COT	R_CHLOROPHYLL-A_biomass_COT
R_CHLOROPHYLL-A_biomass_HRA	R_CHLOROPHYLL-A_biomass_HRA
R_CHLOROPHYLL-B_biomass_COT	R_CHLOROPHYLL-B_biomass_COT
R_CHLOROPHYLL-B_biomass_HRA	R_CHLOROPHYLL-B_biomass_HRA
R_CIT_ACONITATE_mc_COT	R_CIT_ACONITATE_mc_COT
R_CIT_ACONITATE_mc_HRA	R_CIT_ACONITATE_mc_HRA
R_CIT_H+_rev_vc_COT	R_CIT_H+_rev_vc_COT
R_CIT_H+_rev_vc_HRA	R_CIT_H+_rev_vc_HRA
R_CIT_H+_vc_COT	R_CIT_H+_vc_COT
R_CIT_H+_vc_HRA	R_CIT_H+_vc_HRA
R_CIT_ISOCITRATE_mc_COT	R_CIT_ISOCITRATE_mc_COT
R_CIT_ISOCITRATE_mc_HRA	R_CIT_ISOCITRATE_mc_HRA
R_CIT_xc_COT	R_CIT_xc_COT
R_CIT_xc_HRA	R_CIT_xc_HRA
R_CMP_biomass_COT	R_CMP_biomass_COT
R_CMP_biomass_HRA	R_CMP_biomass_HRA
R_CO-A_biomass_COT	R_CO-A_biomass_COT
R_CO-A_biomass_HRA	R_CO-A_biomass_HRA
R_CO2_mc_COT	R_CO2_mc_COT
R_CO2_mc_HRA	R_CO2_mc_HRA
R_CO2_pc_COT	R_CO2_pc_COT
R_CO2_pc_HRA	R_CO2_pc_HRA
R_CO2_tx_COT	R_CO2_tx_COT
R_CO2_tx_HRA	R_CO2_tx_HRA
R_CO2_xc_COT	R_CO2_xc_COT
R_CO2_xc_HRA	R_CO2_xc_HRA
R_CPD-4211_xc_COT	R_CPD-4211_xc_COT
R_CPD-4211_xc_HRA	R_CPD-4211_xc_HRA
R_CPD-499_xc_COT	R_CPD-499_xc_COT
R_CPD-499_xc_HRA	R_CPD-499_xc_HRA
R_CPD-7836_xc_COT	CPD-7836
R_CPD-7836_xc_HRA	CPD-7836
R_CYS_mc_COT	R_CYS_mc_COT
R_CYS_mc_HRA	R_CYS_mc_HRA
R_CYS_pc_COT	R_CYS_pc_COT
R_CYS_pc_HRA	R_CYS_pc_HRA
R_Ca_biomass_COT	R_Ca_biomass_COT
R_Ca_biomass_HRA	R_Ca_biomass_HRA
R_Ca_tx_COT	R_Ca_tx_COT
R_Ca_tx_HRA	R_Ca_tx_HRA
R_Cellulose_biomass_COT	R_Cellulose_biomass_COT
R_Cellulose_biomass_HRA	R_Cellulose_biomass_HRA
R_Cellwall_biomass_COT	R_Cellwall_biomass_COT
R_Cellwall_biomass_HRA	R_Cellwall_biomass_HRA
R_Cellwall_tx_COT	R_Cellwall_tx_COT
R_Cellwall_tx_HRA	R_Cellwall_tx_HRA
R_ConOL_biomass_COT	R_ConOL_biomass_COT
R_ConOL_biomass_HRA	R_ConOL_biomass_HRA
R_CoumOL_biomass_COT	R_CoumOL_biomass_COT
R_CoumOL_biomass_HRA	R_CoumOL_biomass_HRA
R_Cysteine-Trans-PHL	R_Cysteine-Trans-PHL
R_DELTA3-ISOPENTENYL-PP_pc_COT	R_DELTA3-ISOPENTENYL-PP_pc_COT
R_DELTA3-ISOPENTENYL-PP_pc_HRA	R_DELTA3-ISOPENTENYL-PP_pc_HRA
R_DELTA3-ISOPENTENYL-PP_xc_COT	R_DELTA3-ISOPENTENYL-PP_xc_COT
R_DELTA3-ISOPENTENYL-PP_xc_HRA	R_DELTA3-ISOPENTENYL-PP_xc_HRA
R_DHAP_3PGA_pc_COT	R_DHAP_3PGA_pc_COT
R_DHAP_3PGA_pc_HRA	R_DHAP_3PGA_pc_HRA
R_DHAP_Pi_pc_COT	R_DHAP_Pi_pc_COT
R_DHAP_Pi_pc_HRA	R_DHAP_Pi_pc_HRA
R_DI-H-OROTATE_pc_COT	R_DI-H-OROTATE_pc_COT
R_DI-H-OROTATE_pc_HRA	R_DI-H-OROTATE_pc_HRA
R_DIHYDROPICRED-RXN-(NADP)_p_COT	R_DIHYDROPICRED-RXN-(NADP)_p_COT
R_DIHYDROPICRED-RXN-(NADP)_p_HRA	R_DIHYDROPICRED-RXN-(NADP)_p_HRA
R_DIHYDROPICRED-RXN-NAD_p_COT	2,3,4,5-tetrahydrodipicolinate:NAD(P)<small><sup>+</sup></small> oxidoreductase
R_DIHYDROPICRED-RXN-NAD_p_HRA	2,3,4,5-tetrahydrodipicolinate:NAD(P)<small><sup>+</sup></small> oxidoreductase
R_DNA_Processing_c_COT	R_DNA_Processing_c_COT
R_DNA_Processing_c_HRA	R_DNA_Processing_c_HRA
R_DODECANOATE_xc_COT	DODECANOATE
R_DODECANOATE_xc_HRA	DODECANOATE
R_DUMP_mc_COT	R_DUMP_mc_COT
R_DUMP_mc_HRA	R_DUMP_mc_HRA
R_Dodecanoate_ACT_x_COT	Dodecanoate_ACT
R_Dodecanoate_ACT_x_HRA	Dodecanoate_ACT
R_Dodecanoate_biomass_COT	R_Dodecanoate_biomass_COT
R_Dodecanoate_biomass_HRA	R_Dodecanoate_biomass_HRA
R_Dodecanoate_pc_COT	Dodecanoate
R_Dodecanoate_pc_HRA	Dodecanoate
R_ESTRADIOL-17-BETA-DEHYDROGENASE-RXN-NADP_c_COT	ESTRADIOL-17-BETA-DEHYDROGENASE-RXN
R_ESTRADIOL-17-BETA-DEHYDROGENASE-RXN-NADP_c_HRA	ESTRADIOL-17-BETA-DEHYDROGENASE-RXN
R_ESTRADIOL-17-BETA-DEHYDROGENASE-RXN-NAD_c_COT	ESTRADIOL-17-BETA-DEHYDROGENASE-RXN
R_ESTRADIOL-17-BETA-DEHYDROGENASE-RXN-NAD_c_HRA	ESTRADIOL-17-BETA-DEHYDROGENASE-RXN
R_FAD_biomass_COT	R_FAD_biomass_COT
R_FAD_biomass_HRA	R_FAD_biomass_HRA
R_FAD_reg_m_COT	FAD
R_FAD_reg_m_HRA	FAD
R_FAD_reg_x_COT	FAD
R_FAD_reg_x_HRA	FAD
R_FORMATE_mc_COT	R_FORMATE_mc_COT
R_FORMATE_mc_HRA	R_FORMATE_mc_HRA
R_FORMATE_pc_COT	R_FORMATE_pc_COT
R_FORMATE_pc_HRA	R_FORMATE_pc_HRA
R_FRU_H+_rev_vc_COT	R_FRU_H+_rev_vc_COT
R_FRU_H+_rev_vc_HRA	R_FRU_H+_rev_vc_HRA
R_FRU_vc_COT	R_FRU_vc_COT
R_FRU_vc_HRA	R_FRU_vc_HRA
R_FUCOSE_biomass_COT	R_FUCOSE_biomass_COT
R_FUCOSE_biomass_HRA	R_FUCOSE_biomass_HRA
R_FUM_H+_rev_vc_COT	R_FUM_H+_rev_vc_COT
R_FUM_H+_rev_vc_HRA	R_FUM_H+_rev_vc_HRA
R_FUM_H+_vc_COT	R_FUM_H+_vc_COT
R_FUM_H+_vc_HRA	R_FUM_H+_vc_HRA
R_FattyAcid_biomass_COT	R_FattyAcid_biomass_COT
R_FattyAcid_biomass_HRA	R_FattyAcid_biomass_HRA
R_Fe_tx_COT	R_Fe_tx_COT
R_Fe_tx_HRA	R_Fe_tx_HRA
R_Ferredoxin_Plastoquinone_Reductase_p_COT	Ferredoxin_Plastoquinone_Reductase
R_Ferredoxin_Plastoquinone_Reductase_p_HRA	Ferredoxin_Plastoquinone_Reductase
R_G6P_Pi_pc_COT	R_G6P_Pi_pc_COT
R_G6P_Pi_pc_HRA	R_G6P_Pi_pc_HRA
R_GALACTOSE_biomass_COT	R_GALACTOSE_biomass_COT
R_GALACTOSE_biomass_HRA	R_GALACTOSE_biomass_HRA
R_GAP_3PGA_pc_COT	R_GAP_3PGA_pc_COT
R_GAP_3PGA_pc_HRA	R_GAP_3PGA_pc_HRA
R_GAP_Pi_pc_COT	R_GAP_Pi_pc_COT
R_GAP_Pi_pc_HRA	R_GAP_Pi_pc_HRA
R_GLC_H+_rev_vc_COT	R_GLC_H+_rev_vc_COT
R_GLC_H+_rev_vc_HRA	R_GLC_H+_rev_vc_HRA
R_GLC_pc_COT	R_GLC_pc_COT
R_GLC_pc_HRA	R_GLC_pc_HRA
R_GLC_tx_COT	R_GLC_tx_COT
R_GLC_tx_HRA	R_GLC_tx_HRA
R_GLC_vc_COT	R_GLC_vc_COT
R_GLC_vc_HRA	R_GLC_vc_HRA
R_GLN_GLU_mc_COT	R_GLN_GLU_mc_COT
R_GLN_GLU_mc_HRA	R_GLN_GLU_mc_HRA
R_GLN_GLU_pc_COT	R_GLN_GLU_pc_COT
R_GLN_GLU_pc_HRA	R_GLN_GLU_pc_HRA
R_GLT_MAL_pc_COT	R_GLT_MAL_pc_COT
R_GLT_MAL_pc_HRA	R_GLT_MAL_pc_HRA
R_GLT_xc_COT	R_GLT_xc_COT
R_GLT_xc_HRA	R_GLT_xc_HRA
R_GLUTACONYL-COA_CO-A_mc_COT	R_GLUTACONYL-COA_CO-A_mc_COT
R_GLUTACONYL-COA_CO-A_mc_HRA	R_GLUTACONYL-COA_CO-A_mc_HRA
R_GLUTACONYL-COA_CO-A_xc_COT	R_GLUTACONYL-COA_CO-A_xc_COT
R_GLUTACONYL-COA_CO-A_xc_HRA	R_GLUTACONYL-COA_CO-A_xc_HRA
R_GLUTATHIONE_biomass_COT	R_GLUTATHIONE_biomass_COT
R_GLUTATHIONE_biomass_HRA	R_GLUTATHIONE_biomass_HRA
R_GLUTATHIONE_pc_COT	R_GLUTATHIONE_pc_COT
R_GLUTATHIONE_pc_HRA	R_GLUTATHIONE_pc_HRA
R_GLYCERATE_pc_COT	R_GLYCERATE_pc_COT
R_GLYCERATE_pc_HRA	R_GLYCERATE_pc_HRA
R_GLY_mc_COT	R_GLY_mc_COT
R_GLY_mc_HRA	R_GLY_mc_HRA
R_GLY_pc_COT	R_GLY_pc_COT
R_GLY_pc_HRA	R_GLY_pc_HRA
R_GLY_xc_COT	R_GLY_xc_COT
R_GLY_xc_HRA	R_GLY_xc_HRA
R_GMP_biomass_COT	R_GMP_biomass_COT
R_GMP_biomass_HRA	R_GMP_biomass_HRA
R_Galacturonate_biomass_COT	R_Galacturonate_biomass_COT
R_Galacturonate_biomass_HRA	R_Galacturonate_biomass_HRA
R_Glutamate-Trans-PHL	R_Glutamate-Trans-PHL
R_Glutamine-Trans-PHL	R_Glutamine-Trans-PHL
R_Glycerate_xc_COT	R_Glycerate_xc_COT
R_Glycerate_xc_HRA	R_Glycerate_xc_HRA
R_Glycerol-3P_biomass_COT	R_Glycerol-3P_biomass_COT
R_Glycerol-3P_biomass_HRA	R_Glycerol-3P_biomass_HRA
R_Glycerol_biomass_COT	R_Glycerol_biomass_COT
R_Glycerol_biomass_HRA	R_Glycerol_biomass_HRA
R_Glycine-Trans-PHL	R_Glycine-Trans-PHL
R_Glycolate_pc_COT	R_Glycolate_pc_COT
R_Glycolate_pc_HRA	R_Glycolate_pc_HRA
R_Glycolate_xc_COT	R_Glycolate_xc_COT
R_Glycolate_xc_HRA	R_Glycolate_xc_HRA
R_H+(ATP)_rev_vc_COT	R_H+(ATP)_rev_vc_COT
R_H+(ATP)_rev_vc_HRA	R_H+(ATP)_rev_vc_HRA
R_H+(PPi)_rev_vc_COT	R_H+(PPi)_rev_vc_COT
R_H+(PPi)_rev_vc_HRA	R_H+(PPi)_rev_vc_HRA
R_H+_ATPase_c_COT	H+_ATPase_c
R_H+_ATPase_c_HRA	H+_ATPase_c
R_H+_PPiase_m_COT	H+_Ppiase
R_H+_PPiase_m_HRA	H+_Ppiase
R_H2O_mc_COT	R_H2O_mc_COT
R_H2O_mc_HRA	R_H2O_mc_HRA
R_H2O_pc_COT	R_H2O_pc_COT
R_H2O_pc_HRA	R_H2O_pc_HRA
R_H2O_tx_COT	R_H2O_tx_COT
R_H2O_tx_HRA	R_H2O_tx_HRA
R_H2O_vc_COT	R_H2O_vc_COT
R_H2O_vc_HRA	R_H2O_vc_HRA
R_H2O_xc_COT	R_H2O_xc_COT
R_H2O_xc_HRA	R_H2O_xc_HRA
R_HIS_CITRULLINE_mc_COT	R_HIS_CITRULLINE_mc_COT
R_HIS_CITRULLINE_mc_HRA	R_HIS_CITRULLINE_mc_HRA
R_HIS_ORNITHINE_mc_COT	R_HIS_ORNITHINE_mc_COT
R_HIS_ORNITHINE_mc_HRA	R_HIS_ORNITHINE_mc_HRA
R_HIS_pc_COT	R_HIS_pc_COT
R_HIS_pc_HRA	R_HIS_pc_HRA
R_HOMO-CYS_pc_COT	R_HOMO-CYS_pc_COT
R_HOMO-CYS_pc_HRA	R_HOMO-CYS_pc_HRA
R_HOMOSERDEHYDROG-RXN-(NADP)_p_COT	R_HOMOSERDEHYDROG-RXN-(NADP)_p_COT
R_HOMOSERDEHYDROG-RXN-(NADP)_p_HRA	R_HOMOSERDEHYDROG-RXN-(NADP)_p_HRA
R_HOMOSERDEHYDROG-RXN-NAD_p_COT	HOMOSERDEHYDROG-RXN
R_HOMOSERDEHYDROG-RXN-NAD_p_HRA	HOMOSERDEHYDROG-RXN
R_HS_mc_COT	R_HS_mc_COT
R_HS_mc_HRA	R_HS_mc_HRA
R_HS_pc_COT	R_HS_pc_COT
R_HS_pc_HRA	R_HS_pc_HRA
R_HYDROXYPHNYL-TRANS_pc_COT	HYDROXYPHNYL-TRANS
R_HYDROXYPHNYL-TRANS_pc_HRA	HYDROXYPHNYL-TRANS
R_HYDROXYPYRUVATE-REDUCTASE-RXN-NADP_c_COT	HYDROXYPYRUVATE-REDUCTASE-RXN
R_HYDROXYPYRUVATE-REDUCTASE-RXN-NADP_c_HRA	HYDROXYPYRUVATE-REDUCTASE-RXN
R_HYDROXYPYRUVATE-REDUCTASE-RXN-NADP_p_COT	HYDROXYPYRUVATE-REDUCTASE-RXN
R_HYDROXYPYRUVATE-REDUCTASE-RXN-NADP_p_HRA	HYDROXYPYRUVATE-REDUCTASE-RXN
R_HYDROXYPYRUVATE-REDUCTASE-RXN-NAD_x_COT	HYDROXYPYRUVATE-REDUCTASE-RXN
R_HYDROXYPYRUVATE-REDUCTASE-RXN-NAD_x_HRA	HYDROXYPYRUVATE-REDUCTASE-RXN
R_Histidine-Trans-PHL	R_Histidine-Trans-PHL
R_ICOSANOYL-COA-SYNTHASE-RXN-NADP_c_COT	ICOSANOYL-COA-SYNTHASE-RXN
R_ICOSANOYL-COA-SYNTHASE-RXN-NADP_c_HRA	ICOSANOYL-COA-SYNTHASE-RXN
R_ICOSANOYL-COA-SYNTHASE-RXN-NAD_c_COT	ICOSANOYL-COA-SYNTHASE-RXN
R_ICOSANOYL-COA-SYNTHASE-RXN-NAD_c_HRA	ICOSANOYL-COA-SYNTHASE-RXN
R_ILE_mc_COT	R_ILE_mc_COT
R_ILE_mc_HRA	R_ILE_mc_HRA
R_ILE_pc_COT	R_ILE_pc_COT
R_ILE_pc_HRA	R_ILE_pc_HRA
R_INDOLE_ACETATE_AUXIN_biomass_COT	R_INDOLE_ACETATE_AUXIN_biomass_COT
R_INDOLE_ACETATE_AUXIN_biomass_HRA	R_INDOLE_ACETATE_AUXIN_biomass_HRA
R_INDOLE_ACETATE_AUXIN_pc_COT	R_INDOLE_ACETATE_AUXIN_pc_COT
R_INDOLE_ACETATE_AUXIN_pc_HRA	R_INDOLE_ACETATE_AUXIN_pc_HRA
R_INOSITOL_H+_vc_COT	R_INOSITOL_H+_vc_COT
R_INOSITOL_H+_vc_HRA	R_INOSITOL_H+_vc_HRA
R_ISOCITRATE_ACONITATE_mc_COT	R_ISOCITRATE_ACONITATE_mc_COT
R_ISOCITRATE_ACONITATE_mc_HRA	R_ISOCITRATE_ACONITATE_mc_HRA
R_ISPH2-RXN-NADP_p_COT	ISPH2-RXN
R_ISPH2-RXN-NADP_p_HRA	ISPH2-RXN
R_ISPH2-RXN-NAD_p_COT	ISPH2-RXN
R_ISPH2-RXN-NAD_p_HRA	ISPH2-RXN
R_Isoleucine-Trans-PHL	R_Isoleucine-Trans-PHL
R_K+_rev_vc_COT	R_K+_rev_vc_COT
R_K+_rev_vc_HRA	R_K+_rev_vc_HRA
R_K_biomass_COT	R_K_biomass_COT
R_K_biomass_HRA	R_K_biomass_HRA
R_K_tx_COT	R_K_tx_COT
R_K_tx_HRA	R_K_tx_HRA
R_L-ASPARTATE_GLU_mc_COT	R_L-ASPARTATE_GLU_mc_COT
R_L-ASPARTATE_GLU_mc_HRA	R_L-ASPARTATE_GLU_mc_HRA
R_L-ASPARTATE_pc_COT	R_L-ASPARTATE_pc_COT
R_L-ASPARTATE_pc_HRA	R_L-ASPARTATE_pc_HRA
R_L-ASPARTATE_xc_COT	R_L-ASPARTATE_xc_COT
R_L-ASPARTATE_xc_HRA	R_L-ASPARTATE_xc_HRA
R_L-CITRULLINE_pc_COT	R_L-CITRULLINE_pc_COT
R_L-CITRULLINE_pc_HRA	R_L-CITRULLINE_pc_HRA
R_L-GAMMA-GLUTAMYLCYSTEINE_pc_COT	R_L-GAMMA-GLUTAMYLCYSTEINE_pc_COT
R_L-GAMMA-GLUTAMYLCYSTEINE_pc_HRA	R_L-GAMMA-GLUTAMYLCYSTEINE_pc_HRA
R_LEGHEMOGLOBIN-REDUCTASE-RXN-NADP_c_COT	LEGHEMOGLOBIN-REDUCTASE-RXN
R_LEGHEMOGLOBIN-REDUCTASE-RXN-NADP_c_HRA	LEGHEMOGLOBIN-REDUCTASE-RXN
R_LEGHEMOGLOBIN-REDUCTASE-RXN-NAD_c_COT	LEGHEMOGLOBIN-REDUCTASE-RXN
R_LEGHEMOGLOBIN-REDUCTASE-RXN-NAD_c_HRA	LEGHEMOGLOBIN-REDUCTASE-RXN
R_LEU_mc_COT	R_LEU_mc_COT
R_LEU_mc_HRA	R_LEU_mc_HRA
R_LEU_pc_COT	R_LEU_pc_COT
R_LEU_pc_HRA	R_LEU_pc_HRA
R_LINOLEIC_ACID_xc_COT	LINOLEIC
R_LINOLEIC_ACID_xc_HRA	LINOLEIC
R_LINOLENIC_ACID_xc_COT	LINOLENIC
R_LINOLENIC_ACID_xc_HRA	LINOLENIC
R_LYS_CITRULLINE_mc_COT	R_LYS_CITRULLINE_mc_COT
R_LYS_CITRULLINE_mc_HRA	R_LYS_CITRULLINE_mc_HRA
R_LYS_HIS_mc_COT	R_LYS_HIS_mc_COT
R_LYS_HIS_mc_HRA	R_LYS_HIS_mc_HRA
R_LYS_ORNITHINE_mc_COT	R_LYS_ORNITHINE_mc_COT
R_LYS_ORNITHINE_mc_HRA	R_LYS_ORNITHINE_mc_HRA
R_LYS_pc_COT	R_LYS_pc_COT
R_LYS_pc_HRA	R_LYS_pc_HRA
R_Lauroyl-CoA_oxi_x_COT	Lauroyl-CoA_oxi
R_Lauroyl-CoA_oxi_x_HRA	Lauroyl-CoA_oxi
R_Leucine-Trans-PHL	R_Leucine-Trans-PHL
R_Linoleate_ACT_x_COT	Linoleate_ACT
R_Linoleate_ACT_x_HRA	Linoleate_ACT
R_Linoleate_biomass_COT	R_Linoleate_biomass_COT
R_Linoleate_biomass_HRA	R_Linoleate_biomass_HRA
R_Linoleate_pc_COT	Linoleate
R_Linoleate_pc_HRA	Linoleate
R_Linolenate_biomass_COT	R_Linolenate_biomass_COT
R_Linolenate_biomass_HRA	R_Linolenate_biomass_HRA
R_Linolenoyl-ACP-desaturase_p_COT	R_Linolenoyl-ACP-desaturase_p_COT
R_Linolenoyl-ACP-desaturase_p_HRA	R_Linolenoyl-ACP-desaturase_p_HRA
R_Linolenoyl-CoA_oxi_x_COT	Linolenoyl-CoA_oxi
R_Linolenoyl-CoA_oxi_x_HRA	Linolenoyl-CoA_oxi
R_Linoleoyl-ACP-desaturase_p_COT	R_Linoleoyl-ACP-desaturase_p_COT
R_Linoleoyl-ACP-desaturase_p_HRA	R_Linoleoyl-ACP-desaturase_p_HRA
R_Linoleoyl-ACP-hydrolase_p_COT	Linoleoyl-ACP-hydrolase
R_Linoleoyl-ACP-hydrolase_p_HRA	Linoleoyl-ACP-hydrolase
R_Linoleoyl-CoA_oxi_x_COT	Linoleoyl-CoA_oxi
R_Linoleoyl-CoA_oxi_x_HRA	Linoleoyl-CoA_oxi
R_Lysine-Trans-PHL	R_Lysine-Trans-PHL
R_MALONATE-S-ALD-DH_m_COT	RXN-11213
R_MALONATE-S-ALD-DH_m_HRA	RXN-11213
R_MALTOSE_pc_COT	R_MALTOSE_pc_COT
R_MALTOSE_pc_HRA	R_MALTOSE_pc_HRA
R_MAL_ACONITATE_mc_COT	R_MAL_ACONITATE_mc_COT
R_MAL_ACONITATE_mc_HRA	R_MAL_ACONITATE_mc_HRA
R_MAL_CIT_mc_COT	R_MAL_CIT_mc_COT
R_MAL_CIT_mc_HRA	R_MAL_CIT_mc_HRA
R_MAL_H+_rev_vc_COT	R_MAL_H+_rev_vc_COT
R_MAL_H+_rev_vc_HRA	R_MAL_H+_rev_vc_HRA
R_MAL_H+_vc_COT	R_MAL_H+_vc_COT
R_MAL_H+_vc_HRA	R_MAL_H+_vc_HRA
R_MAL_ISOCITRATE_mc_COT	R_MAL_ISOCITRATE_mc_COT
R_MAL_ISOCITRATE_mc_HRA	R_MAL_ISOCITRATE_mc_HRA
R_MAL_Pi_mc_COT	R_MAL_Pi_mc_COT
R_MAL_Pi_mc_HRA	R_MAL_Pi_mc_HRA
R_MAL_SO4_mc_COT	R_MAL_SO4_mc_COT
R_MAL_SO4_mc_HRA	R_MAL_SO4_mc_HRA
R_MAL_SUC_mc_COT	R_MAL_SUC_mc_COT
R_MAL_SUC_mc_HRA	R_MAL_SUC_mc_HRA
R_MAL_xc_COT	R_MAL_xc_COT
R_MAL_xc_HRA	R_MAL_xc_HRA
R_MEPROPCOA-ETF-RXN_m_COT	MEPROPCOA-ETF-RXN
R_MEPROPCOA-ETF-RXN_m_HRA	MEPROPCOA-ETF-RXN
R_METHYLENE-THF_mc_COT	R_METHYLENE-THF_mc_COT
R_METHYLENE-THF_mc_HRA	R_METHYLENE-THF_mc_HRA
R_METHYLENE-THF_pc_COT	R_METHYLENE-THF_pc_COT
R_METHYLENE-THF_pc_HRA	R_METHYLENE-THF_pc_HRA
R_MET_pc_COT	R_MET_pc_COT
R_MET_pc_HRA	R_MET_pc_HRA
R_MG+2_pc_COT	R_MG+2_pc_COT
R_MG+2_pc_HRA	R_MG+2_pc_HRA
R_MG+2_rev_vc_COT	R_MG+2_rev_vc_COT
R_MG+2_rev_vc_HRA	R_MG+2_rev_vc_HRA
R_MTOB_pc_COT	R_MTOB_pc_COT
R_MTOB_pc_HRA	R_MTOB_pc_HRA
R_Maltose_biomass_COT	R_Maltose_biomass_COT
R_Maltose_biomass_HRA	R_Maltose_biomass_HRA
R_Mehler_Reaction_p_COT	Mehler_Reaction
R_Mehler_Reaction_p_HRA	Mehler_Reaction
R_Methanetiol_biomass_COT	R_Methanetiol_biomass_COT
R_Methanetiol_biomass_HRA	R_Methanetiol_biomass_HRA
R_Methionine-Trans-PHL	R_Methionine-Trans-PHL
R_Mg+2_pc_COT	R_Mg+2_pc_COT
R_Mg+2_pc_HRA	R_Mg+2_pc_HRA
R_Mg_biomass_COT	R_Mg_biomass_COT
R_Mg_biomass_HRA	R_Mg_biomass_HRA
R_Mg_tx_COT	R_Mg_tx_COT
R_Mg_tx_HRA	R_Mg_tx_HRA
R_Mitochondrial_ATP_Synthase_m_COT	Mitochondrial_ATP_Synthase
R_Mitochondrial_ATP_Synthase_m_HRA	Mitochondrial_ATP_Synthase
R_Myristate_ACT_x_COT	Myristate_ACT
R_Myristate_ACT_x_HRA	Myristate_ACT
R_Myristate_biomass_COT	R_Myristate_biomass_COT
R_Myristate_biomass_HRA	R_Myristate_biomass_HRA
R_Myristate_pc_COT	Myristate
R_Myristate_pc_HRA	Myristate
R_NADPH_Dehydrogenase_p_COT	NADPH_Dehydrogenase
R_NADPH_Dehydrogenase_p_HRA	NADPH_Dehydrogenase
R_NADPHoxc_tx_COT	R_NADPHoxc_tx_COT
R_NADPHoxc_tx_HRA	R_NADPHoxc_tx_HRA
R_NADPHoxm_tx_COT	R_NADPHoxm_tx_COT
R_NADPHoxm_tx_HRA	R_NADPHoxm_tx_HRA
R_NADPHoxp_tx_COT	R_NADPHoxp_tx_COT
R_NADPHoxp_tx_HRA	R_NADPHoxp_tx_HRA
R_NADPHoxx_tx_COT	R_NADPHoxx_tx_COT
R_NADPHoxx_tx_HRA	R_NADPHoxx_tx_HRA
R_NH3_mc_COT	R_NH3_mc_COT
R_NH3_mc_HRA	R_NH3_mc_HRA
R_NH3_pc_COT	R_NH3_pc_COT
R_NH3_pc_HRA	R_NH3_pc_HRA
R_NH3_xc_COT	R_NH3_xc_COT
R_NH3_xc_HRA	R_NH3_xc_HRA
R_NH4_biomass_COT	R_NH4_biomass_COT
R_NH4_biomass_HRA	R_NH4_biomass_HRA
R_NH4_tx_COT	R_NH4_tx_COT
R_NH4_tx_HRA	R_NH4_tx_HRA
R_NICOTINATE_NUCLEOTIDE_pc_COT	R_NICOTINATE_NUCLEOTIDE_pc_COT
R_NICOTINATE_NUCLEOTIDE_pc_HRA	R_NICOTINATE_NUCLEOTIDE_pc_HRA
R_NITRATE_H+_rev_vc_COT	R_NITRATE_H+_rev_vc_COT
R_NITRATE_H+_rev_vc_HRA	R_NITRATE_H+_rev_vc_HRA
R_NITRATE_vc_COT	R_NITRATE_vc_COT
R_NITRATE_vc_HRA	R_NITRATE_vc_HRA
R_NITRIC-OXIDE_biomass_COT	R_NITRIC-OXIDE_biomass_COT
R_NITRIC-OXIDE_biomass_HRA	R_NITRIC-OXIDE_biomass_HRA
R_NITRITE_pc_COT	R_NITRITE_pc_COT
R_NITRITE_pc_HRA	R_NITRITE_pc_HRA
R_NO3_biomass_COT	R_NO3_biomass_COT
R_NO3_biomass_HRA	R_NO3_biomass_HRA
R_NO3_tx_COT	R_NO3_tx_COT
R_NO3_tx_HRA	R_NO3_tx_HRA
R_Nitrate-Trans-PHL	R_Nitrate-Trans-PHL
R_O2_mc_COT	R_O2_mc_COT
R_O2_mc_HRA	R_O2_mc_HRA
R_O2_pc_COT	R_O2_pc_COT
R_O2_pc_HRA	R_O2_pc_HRA
R_O2_tx_COT	R_O2_tx_COT
R_O2_tx_HRA	R_O2_tx_HRA
R_O2_xc_COT	R_O2_xc_COT
R_O2_xc_HRA	R_O2_xc_HRA
R_OAA_ACONITATE_mc_COT	R_OAA_ACONITATE_mc_COT
R_OAA_ACONITATE_mc_HRA	R_OAA_ACONITATE_mc_HRA
R_OAA_CIT_mc_COT	R_OAA_CIT_mc_COT
R_OAA_CIT_mc_HRA	R_OAA_CIT_mc_HRA
R_OAA_ISOCITRATE_mc_COT	R_OAA_ISOCITRATE_mc_COT
R_OAA_ISOCITRATE_mc_HRA	R_OAA_ISOCITRATE_mc_HRA
R_OAA_MAL_mc_COT	R_OAA_MAL_mc_COT
R_OAA_MAL_mc_HRA	R_OAA_MAL_mc_HRA
R_OAA_MAL_pc_COT	R_OAA_MAL_pc_COT
R_OAA_MAL_pc_HRA	R_OAA_MAL_pc_HRA
R_OAA_Pi_mc_COT	R_OAA_Pi_mc_COT
R_OAA_Pi_mc_HRA	R_OAA_Pi_mc_HRA
R_OAA_SO4_mc_COT	R_OAA_SO4_mc_COT
R_OAA_SO4_mc_HRA	R_OAA_SO4_mc_HRA
R_OAA_SUC_mc_COT	R_OAA_SUC_mc_COT
R_OAA_SUC_mc_HRA	R_OAA_SUC_mc_HRA
R_OAA_xc_COT	R_OAA_xc_COT
R_OAA_xc_HRA	R_OAA_xc_HRA
R_OLEATE_CPD_xc_COT	OLEATE_CPD
R_OLEATE_CPD_xc_HRA	OLEATE_CPD
R_ORNITHINE_CITRULLINE_mc_COT	R_ORNITHINE_CITRULLINE_mc_COT
R_ORNITHINE_CITRULLINE_mc_HRA	R_ORNITHINE_CITRULLINE_mc_HRA
R_ORNITHINE_CITRULLINE_pc_COT	R_ORNITHINE_CITRULLINE_pc_COT
R_ORNITHINE_CITRULLINE_pc_HRA	R_ORNITHINE_CITRULLINE_pc_HRA
R_OROTATE_pc_COT	R_OROTATE_pc_COT
R_OROTATE_pc_HRA	R_OROTATE_pc_HRA
R_Oleate_ACT_x_COT	Oleate_ACT
R_Oleate_ACT_x_HRA	Oleate_ACT
R_Oleate_biomass_COT	R_Oleate_biomass_COT
R_Oleate_biomass_HRA	R_Oleate_biomass_HRA
R_Oleate_pc_COT	Oleate
R_Oleate_pc_HRA	Oleate
R_Oleoyl-CoA_oxi_x_COT	Oleoyl-CoA_oxi
R_Oleoyl-CoA_oxi_x_HRA	Oleoyl-CoA_oxi
R_P-AMINO-BENZOATE_mc_COT	R_P-AMINO-BENZOATE_mc_COT
R_P-AMINO-BENZOATE_mc_HRA	R_P-AMINO-BENZOATE_mc_HRA
R_P-AMINO-BENZOATE_pc_COT	R_P-AMINO-BENZOATE_pc_COT
R_P-AMINO-BENZOATE_pc_HRA	R_P-AMINO-BENZOATE_pc_HRA
R_PALMITATE_pc_COT	R_PALMITATE_pc_COT
R_PALMITATE_pc_HRA	R_PALMITATE_pc_HRA
R_PALMITATE_rev_xc_COT	R_PALMITATE_rev_xc_COT
R_PALMITATE_rev_xc_HRA	R_PALMITATE_rev_xc_HRA
R_PALMITATE_xc_COT	R_PALMITATE_xc_COT
R_PALMITATE_xc_HRA	R_PALMITATE_xc_HRA
R_PAPS_biomass_COT	R_PAPS_biomass_COT
R_PAPS_biomass_HRA	R_PAPS_biomass_HRA
R_PAPS_pc_COT	R_PAPS_pc_COT
R_PAPS_pc_HRA	R_PAPS_pc_HRA
R_PEP_Pi_pc_COT	R_PEP_Pi_pc_COT
R_PEP_Pi_pc_HRA	R_PEP_Pi_pc_HRA
R_PHE_pc_COT	R_PHE_pc_COT
R_PHE_pc_HRA	R_PHE_pc_HRA
R_PROLINE-DEHYDROGENASE_m_COT	PROLINE-DEHYDROGENASE
R_PROLINE-DEHYDROGENASE_m_HRA	PROLINE-DEHYDROGENASE
R_PROPIONYL-COA_mc_COT	R_PROPIONYL-COA_mc_COT
R_PROPIONYL-COA_mc_HRA	R_PROPIONYL-COA_mc_HRA
R_PROPIONYL-COA_xc_COT	R_PROPIONYL-COA_xc_COT
R_PROPIONYL-COA_xc_HRA	R_PROPIONYL-COA_xc_HRA
R_PROTEIN-HYDROLYSIS_c_COT	R_PROTEIN-HYDROLYSIS_c_COT
R_PROTEIN-HYDROLYSIS_c_HRA	R_PROTEIN-HYDROLYSIS_c_HRA
R_PROTEIN-SYNTHASE_c_COT	R_PROTEIN-SYNTHASE_c_COT
R_PROTEIN-SYNTHASE_c_HRA	R_PROTEIN-SYNTHASE_c_HRA
R_PROTON_mc_COT	R_PROTON_mc_COT
R_PROTON_mc_HRA	R_PROTON_mc_HRA
R_PROTON_pc_COT	R_PROTON_pc_COT
R_PROTON_pc_HRA	R_PROTON_pc_HRA
R_PROTON_tx_COT	R_PROTON_tx_COT
R_PROTON_tx_HRA	R_PROTON_tx_HRA
R_PROTON_vc_COT	R_PROTON_vc_COT
R_PROTON_vc_HRA	R_PROTON_vc_HRA
R_PROTON_xc_COT	R_PROTON_xc_COT
R_PROTON_xc_HRA	R_PROTON_xc_HRA
R_PROTOPORPHYRINOGEN_mc_COT	R_PROTOPORPHYRINOGEN_mc_COT
R_PROTOPORPHYRINOGEN_mc_HRA	R_PROTOPORPHYRINOGEN_mc_HRA
R_PRO_GLU_mc_COT	R_PRO_GLU_mc_COT
R_PRO_GLU_mc_HRA	R_PRO_GLU_mc_HRA
R_PRO_mc_COT	R_PRO_mc_COT
R_PRO_mc_HRA	R_PRO_mc_HRA
R_PRO_pc_COT	R_PRO_pc_COT
R_PRO_pc_HRA	R_PRO_pc_HRA
R_PYRROLINECARBREDUCT-RXN-NADP_c_COT	PYRROLINECARBREDUCT-RXN
R_PYRROLINECARBREDUCT-RXN-NADP_c_HRA	PYRROLINECARBREDUCT-RXN
R_PYRROLINECARBREDUCT-RXN-NADP_p_COT	PYRROLINECARBREDUCT-RXN
R_PYRROLINECARBREDUCT-RXN-NADP_p_HRA	PYRROLINECARBREDUCT-RXN
R_PYRROLINECARBREDUCT-RXN-NAD_c_COT	PYRROLINECARBREDUCT-RXN
R_PYRROLINECARBREDUCT-RXN-NAD_c_HRA	PYRROLINECARBREDUCT-RXN
R_PYRROLINECARBREDUCT-RXN-NAD_p_COT	PYRROLINECARBREDUCT-RXN
R_PYRROLINECARBREDUCT-RXN-NAD_p_HRA	PYRROLINECARBREDUCT-RXN
R_PYRUVATE_H+_mc_COT	R_PYRUVATE_H+_mc_COT
R_PYRUVATE_H+_mc_HRA	R_PYRUVATE_H+_mc_HRA
R_PYRUVATE_pc_COT	R_PYRUVATE_pc_COT
R_PYRUVATE_pc_HRA	R_PYRUVATE_pc_HRA
R_Palmitate_ACT_x_COT	Palmitate_ACT
R_Palmitate_ACT_x_HRA	Palmitate_ACT
R_Palmitate_biomass_COT	R_Palmitate_biomass_COT
R_Palmitate_biomass_HRA	R_Palmitate_biomass_HRA
R_Palmityl-CoA_oxi_x_COT	Palmityl-CoA_oxi
R_Palmityl-CoA_oxi_x_HRA	Palmityl-CoA_oxi
R_Phenylalanine-Trans-PHL	R_Phenylalanine-Trans-PHL
R_Phosphate-Trans-PHL	R_Phosphate-Trans-PHL
R_Photon_tx_COT	R_Photon_tx_COT
R_Photon_tx_HRA	R_Photon_tx_HRA
R_Pi_H+_mc_COT	R_Pi_H+_mc_COT
R_Pi_H+_mc_HRA	R_Pi_H+_mc_HRA
R_Pi_H+_pc_COT	R_Pi_H+_pc_COT
R_Pi_H+_pc_HRA	R_Pi_H+_pc_HRA
R_Pi_biomass_COT	R_Pi_biomass_COT
R_Pi_biomass_HRA	R_Pi_biomass_HRA
R_Pi_tx_COT	R_Pi_tx_COT
R_Pi_tx_HRA	R_Pi_tx_HRA
R_Pi_vc_COT	R_Pi_vc_COT
R_Pi_vc_HRA	R_Pi_vc_HRA
R_Pi_xc_COT	R_Pi_xc_COT
R_Pi_xc_HRA	R_Pi_xc_HRA
R_Plastidial_ATP_Synthase_p_COT	Plastidial_ATP_Synthase
R_Plastidial_ATP_Synthase_p_HRA	Plastidial_ATP_Synthase
R_Plastoquinol_Oxidase_p_COT	Plastoquinol_Oxidase
R_Plastoquinol_Oxidase_p_HRA	Plastoquinol_Oxidase
R_Proline-Trans-PHL	R_Proline-Trans-PHL
R_Protein_Polymerisation_c_COT	R_Protein_Polymerisation_c_COT
R_Protein_Polymerisation_c_HRA	R_Protein_Polymerisation_c_HRA
R_Protein_Processing_c_COT	R_Protein_Processing_c_COT
R_Protein_Processing_c_HRA	R_Protein_Processing_c_HRA
R_Protein_Translocation_c_COT	R_Protein_Translocation_c_COT
R_Protein_Translocation_c_HRA	R_Protein_Translocation_c_HRA
R_Protein_biomass_COT	R_Protein_biomass_COT
R_Protein_biomass_HRA	R_Protein_biomass_HRA
R_Protein_tx_COT	R_Protein_tx_COT
R_Protein_tx_HRA	R_Protein_tx_HRA
R_RHAMNOSE_biomass_COT	R_RHAMNOSE_biomass_COT
R_RHAMNOSE_biomass_HRA	R_RHAMNOSE_biomass_HRA
R_RNA_Processing_c_COT	R_RNA_Processing_c_COT
R_RNA_Processing_c_HRA	R_RNA_Processing_c_HRA
R_RXN-10745-NADP_c_COT	RXN-10745
R_RXN-10745-NADP_c_HRA	RXN-10745
R_RXN-10745-NAD_c_COT	RXN-10745
R_RXN-10745-NAD_c_HRA	RXN-10745
R_RXN-11385-NADP_c_COT	RXN-11385
R_RXN-11385-NADP_c_HRA	RXN-11385
R_RXN-11385-NAD_c_COT	RXN-11385
R_RXN-11385-NAD_c_HRA	RXN-11385
R_RXN-11387-NADP_c_COT	RXN-11387
R_RXN-11387-NADP_c_HRA	RXN-11387
R_RXN-11387-NAD_c_COT	RXN-11387
R_RXN-11387-NAD_c_HRA	RXN-11387
R_RXN-11388-NADP_c_COT	RXN-11388
R_RXN-11388-NADP_c_HRA	RXN-11388
R_RXN-11388-NAD_c_COT	RXN-11388
R_RXN-11388-NAD_c_HRA	RXN-11388
R_RXN-12405-NADP_c_COT	dTDP-3,4-diketo-2,6-dideoxy-D-glucose 3-ketoreductase
R_RXN-12405-NADP_c_HRA	dTDP-3,4-diketo-2,6-dideoxy-D-glucose 3-ketoreductase
R_RXN-12405-NAD_c_COT	dTDP-3,4-diketo-2,6-dideoxy-D-glucose 3-ketoreductase
R_RXN-12405-NAD_c_HRA	dTDP-3,4-diketo-2,6-dideoxy-D-glucose 3-ketoreductase
R_RXN-12940-NADP_c_COT	dTDP-(2R,6S)-6-hydroxy-2-methyl-3-oxo-3,6-dihydro-2<i>H</i>-pyran-4-olate 3-ketoreductase (dTDP-4-dehydro-2,6-dideoxy-&alpha;-D-allose-forming)
R_RXN-12940-NADP_c_HRA	dTDP-(2R,6S)-6-hydroxy-2-methyl-3-oxo-3,6-dihydro-2<i>H</i>-pyran-4-olate 3-ketoreductase (dTDP-4-dehydro-2,6-dideoxy-&alpha;-D-allose-forming)
R_RXN-12940-NAD_c_COT	dTDP-(2R,6S)-6-hydroxy-2-methyl-3-oxo-3,6-dihydro-2<i>H</i>-pyran-4-olate 3-ketoreductase (dTDP-4-dehydro-2,6-dideoxy-&alpha;-D-allose-forming)
R_RXN-12940-NAD_c_HRA	dTDP-(2R,6S)-6-hydroxy-2-methyl-3-oxo-3,6-dihydro-2<i>H</i>-pyran-4-olate 3-ketoreductase (dTDP-4-dehydro-2,6-dideoxy-&alpha;-D-allose-forming)
R_RXN-13162-NADP_c_COT	RXN-13162
R_RXN-13162-NADP_c_HRA	RXN-13162
R_RXN-13162-NAD_c_COT	RXN-13162
R_RXN-13162-NAD_c_HRA	RXN-13162
R_RXN-13188-NADP_c_COT	RXN-13188
R_RXN-13188-NADP_c_HRA	RXN-13188
R_RXN-13188-NAD_c_COT	RXN-13188
R_RXN-13188-NAD_c_HRA	RXN-13188
R_RXN-13193-NADP_c_COT	RXN-13193
R_RXN-13193-NADP_c_HRA	RXN-13193
R_RXN-13193-NAD_c_COT	RXN-13193
R_RXN-13193-NAD_c_HRA	RXN-13193
R_RXN-13463_c_COT	RXN-13463
R_RXN-13463_c_HRA	RXN-13463
R_RXN-14075_c_COT	6C-naringenin dibenzoylmethane tautomer glucosyltransferase
R_RXN-14075_c_HRA	6C-naringenin dibenzoylmethane tautomer glucosyltransferase
R_RXN-14080_c_COT	2-hydroxyeriodictyol dibenzoylmethane tautomer 6C-glucosyltransferase
R_RXN-14080_c_HRA	2-hydroxyeriodictyol dibenzoylmethane tautomer 6C-glucosyltransferase
R_RXN-14086_c_COT	2,5,7-trihydroxyflavanone dibenzoylmethane tautomer 6C-glucosyltransferase
R_RXN-14086_c_HRA	2,5,7-trihydroxyflavanone dibenzoylmethane tautomer 6C-glucosyltransferase
R_RXN-14760-NADP_c_COT	RXN-14760
R_RXN-14760-NADP_c_HRA	RXN-14760
R_RXN-14760-NAD_c_COT	RXN-14760
R_RXN-14760-NAD_c_HRA	RXN-14760
R_RXN-14767-NADP_c_COT	RXN-14767
R_RXN-14767-NADP_c_HRA	RXN-14767
R_RXN-14767-NAD_c_COT	RXN-14767
R_RXN-14767-NAD_c_HRA	RXN-14767
R_RXN-14993_c_COT	RXN-14993
R_RXN-14993_c_HRA	RXN-14993
R_RXN-14994-NADP_c_COT	RXN-14994
R_RXN-14994-NADP_c_HRA	RXN-14994
R_RXN-14994-NAD_c_COT	RXN-14994
R_RXN-14994-NAD_c_HRA	RXN-14994
R_RXN-15029-NADP_c_COT	RXN-15029
R_RXN-15029-NADP_c_HRA	RXN-15029
R_RXN-15029-NAD_c_COT	RXN-15029
R_RXN-15029-NAD_c_HRA	RXN-15029
R_RXN-15325_c_COT	RXN-15325
R_RXN-15325_c_HRA	RXN-15325
R_RXN-2962-NADP_c_COT	RXN-2962
R_RXN-2962-NADP_c_HRA	RXN-2962
R_RXN-2962-NAD_c_COT	RXN-2962
R_RXN-2962-NAD_c_HRA	RXN-2962
R_RXN-6269-NADP_c_COT	methylsterol monooxygenase
R_RXN-6269-NADP_c_HRA	methylsterol monooxygenase
R_RXN-6269-NAD_c_COT	methylsterol monooxygenase
R_RXN-6269-NAD_c_HRA	methylsterol monooxygenase
R_RXN-6271-NADP_c_COT	methylsterol monooxygenase
R_RXN-6271-NADP_c_HRA	methylsterol monooxygenase
R_RXN-6271-NAD_c_COT	methylsterol monooxygenase
R_RXN-6271-NAD_c_HRA	methylsterol monooxygenase
R_RXN-6382-NADP_c_COT	RXN-6382
R_RXN-6382-NADP_c_HRA	RXN-6382
R_RXN-6382-NAD_c_COT	RXN-6382
R_RXN-6382-NAD_c_HRA	RXN-6382
R_RXN-7183-NADP_m_COT	RXN-7183
R_RXN-7183-NADP_m_HRA	RXN-7183
R_RXN-7183-NAD_m_COT	RXN-7183
R_RXN-7183-NAD_m_HRA	RXN-7183
R_RXN-7622-NADP_c_COT	RXN-7622
R_RXN-7622-NADP_c_HRA	RXN-7622
R_RXN-7622-NAD_c_COT	RXN-7622
R_RXN-7622-NAD_c_HRA	RXN-7622
R_RXN-7678-NADP_p_COT	RXN-7678
R_RXN-7678-NADP_p_HRA	RXN-7678
R_RXN-7678-NAD_p_COT	RXN-7678
R_RXN-7678-NAD_p_HRA	RXN-7678
R_RXN-7968-NADP_c_COT	RXN-7968
R_RXN-7968-NADP_c_HRA	RXN-7968
R_RXN-7968-NAD_c_COT	RXN-7968
R_RXN-7968-NAD_c_HRA	RXN-7968
R_RXN-7978-NADP_c_COT	zeaxanthin epoxidase
R_RXN-7978-NADP_c_HRA	zeaxanthin epoxidase
R_RXN-7978-NAD_c_COT	zeaxanthin epoxidase
R_RXN-7978-NAD_c_HRA	zeaxanthin epoxidase
R_RXN-7979-NADP_c_COT	antheraxanthin epoxidase
R_RXN-7979-NADP_c_HRA	antheraxanthin epoxidase
R_RXN-7979-NAD_c_COT	antheraxanthin epoxidase
R_RXN-7979-NAD_c_HRA	antheraxanthin epoxidase
R_RXN-9703-NADP_c_COT	RXN-9703
R_RXN-9703-NADP_c_HRA	RXN-9703
R_RXN-9703-NAD_c_COT	RXN-9703
R_RXN-9703-NAD_c_HRA	RXN-9703
R_RXN-Mg-PROTOPORPHYRIN-METHYLESTER-SYN_p_COT	RXN-Mg-PROTOPORPHYRIN-METHYLESTER-SYN
R_RXN-Mg-PROTOPORPHYRIN-METHYLESTER-SYN_p_HRA	RXN-Mg-PROTOPORPHYRIN-METHYLESTER-SYN
R_RXN0-5330-(NAD)_c_COT	RXN0-5330
R_RXN0-5330-(NAD)_c_HRA	RXN0-5330
R_RXN0-5330-(NAD)_m_COT	RXN0-5330
R_RXN0-5330-(NAD)_m_HRA	RXN0-5330
R_RXN0-5330-(NADP)_c_COT	RXN0-5330
R_RXN0-5330-(NADP)_c_HRA	RXN0-5330
R_RXN0-5330-(NADP)_m_COT	RXN0-5330
R_RXN0-5330-(NADP)_m_HRA	RXN0-5330
R_RXN0-884-NADP_p_COT	RXN0-884
R_RXN0-884-NADP_p_HRA	RXN0-884
R_RXN0-884-NAD_p_COT	RXN0-884
R_RXN0-884-NAD_p_HRA	RXN0-884
R_RXN66-281-NADP_c_COT	squalene synthase
R_RXN66-281-NADP_c_HRA	squalene synthase
R_RXN66-281-NAD_c_COT	squalene synthase
R_RXN66-281-NAD_c_HRA	squalene synthase
R_RXN66-313-NADP_c_COT	RXN66-313
R_RXN66-313-NADP_c_HRA	RXN66-313
R_RXN66-313-NAD_c_COT	RXN66-313
R_RXN66-313-NAD_c_HRA	RXN66-313
R_RXN66-532_c_COT	RXN66-532
R_RXN66-532_c_HRA	RXN66-532
R_RXNQT-1_c_COT	R_RXNQT-1_c_COT
R_RXNQT-1_c_HRA	R_RXNQT-1_c_HRA
R_RXNQT-3_c_COT	R_RXNQT-3_c_COT
R_RXNQT-3_c_HRA	R_RXNQT-3_c_HRA
R_Raffinose-Trans-PHL	R_Raffinose-Trans-PHL
R_Raffinose_biomass_COT	R_Raffinose_biomass_COT
R_Raffinose_biomass_HRA	R_Raffinose_biomass_HRA
R_S-ALLANTOIN_xc_COT	R_S-ALLANTOIN_xc_COT
R_S-ALLANTOIN_xc_HRA	R_S-ALLANTOIN_xc_HRA
R_SAM_SHAC_pc_COT	R_SAM_SHAC_pc_COT
R_SAM_SHAC_pc_HRA	R_SAM_SHAC_pc_HRA
R_SAM_biomass_COT	R_SAM_biomass_COT
R_SAM_biomass_HRA	R_SAM_biomass_HRA
R_SER_mc_COT	R_SER_mc_COT
R_SER_mc_HRA	R_SER_mc_HRA
R_SER_pc_COT	R_SER_pc_COT
R_SER_pc_HRA	R_SER_pc_HRA
R_SER_xc_COT	R_SER_xc_COT
R_SER_xc_HRA	R_SER_xc_HRA
R_SO3_xc_COT	R_SO3_xc_COT
R_SO3_xc_HRA	R_SO3_xc_HRA
R_SO4_biomass_COT	R_SO4_biomass_COT
R_SO4_biomass_HRA	R_SO4_biomass_HRA
R_SO4_pc_COT	R_SO4_pc_COT
R_SO4_pc_HRA	R_SO4_pc_HRA
R_SO4_tx_COT	R_SO4_tx_COT
R_SO4_tx_HRA	R_SO4_tx_HRA
R_SO4_xc_COT	R_SO4_xc_COT
R_SO4_xc_HRA	R_SO4_xc_HRA
R_STEARIC_ACID_xc_COT	STEARIC
R_STEARIC_ACID_xc_HRA	STEARIC
R_SUCROSE_H+_vc_COT	R_SUCROSE_H+_vc_COT
R_SUCROSE_H+_vc_HRA	R_SUCROSE_H+_vc_HRA
R_SUCROSE_rev_vc_COT	R_SUCROSE_rev_vc_COT
R_SUCROSE_rev_vc_HRA	R_SUCROSE_rev_vc_HRA
R_SUC_ACONITATE_mc_COT	R_SUC_ACONITATE_mc_COT
R_SUC_ACONITATE_mc_HRA	R_SUC_ACONITATE_mc_HRA
R_SUC_CIT_mc_COT	R_SUC_CIT_mc_COT
R_SUC_CIT_mc_HRA	R_SUC_CIT_mc_HRA
R_SUC_FUM_mc_COT	R_SUC_FUM_mc_COT
R_SUC_FUM_mc_HRA	R_SUC_FUM_mc_HRA
R_SUC_ISOCITRATE_mc_COT	R_SUC_ISOCITRATE_mc_COT
R_SUC_ISOCITRATE_mc_HRA	R_SUC_ISOCITRATE_mc_HRA
R_SUC_Pi_mc_COT	R_SUC_Pi_mc_COT
R_SUC_Pi_mc_HRA	R_SUC_Pi_mc_HRA
R_SUC_SO4_mc_COT	R_SUC_SO4_mc_COT
R_SUC_SO4_mc_HRA	R_SUC_SO4_mc_HRA
R_SUC_xc_COT	R_SUC_xc_COT
R_SUC_xc_HRA	R_SUC_xc_HRA
R_SULFATE_vc_COT	R_SULFATE_vc_COT
R_SULFATE_vc_HRA	R_SULFATE_vc_HRA
R_Serine-Trans-PHL	R_Serine-Trans-PHL
R_SinapOL_biomass_COT	R_SinapOL_biomass_COT
R_SinapOL_biomass_HRA	R_SinapOL_biomass_HRA
R_Stachyose-Trans-PHL	R_Stachyose-Trans-PHL
R_Stachyose_biomass_COT	R_Stachyose_biomass_COT
R_Stachyose_biomass_HRA	R_Stachyose_biomass_HRA
R_Starch_biomass_COT	R_Starch_biomass_COT
R_Starch_biomass_HRA	R_Starch_biomass_HRA
R_Starch_tx_COT	R_Starch_tx_COT
R_Starch_tx_HRA	R_Starch_tx_HRA
R_Stearate_ACT_c_COT	Stearate_ACT
R_Stearate_ACT_c_HRA	Stearate_ACT
R_Stearate_ACT_x_COT	Stearate_ACT
R_Stearate_ACT_x_HRA	Stearate_ACT
R_Stearate_biomass_COT	R_Stearate_biomass_COT
R_Stearate_biomass_HRA	R_Stearate_biomass_HRA
R_Stearate_pc_COT	Stearate
R_Stearate_pc_HRA	Stearate
R_Stearoyl-CoA_oxi_x_COT	Stearoyl-CoA_oxi
R_Stearoyl-CoA_oxi_x_HRA	Stearoyl-CoA_oxi
R_Succinate-Trans-PHL	R_Succinate-Trans-PHL
R_Sucrose-Trans-PHL	R_Sucrose-Trans-PHL
R_Sucrose_tx_COT	R_Sucrose_tx_COT
R_Sucrose_tx_HRA	R_Sucrose_tx_HRA
R_Sulfate-Trans-PHL	R_Sulfate-Trans-PHL
R_TAG_biomass_COT	R_TAG_biomass_COT
R_TAG_biomass_HRA	R_TAG_biomass_HRA
R_TAG_tx_COT	R_TAG_tx_COT
R_TAG_tx_HRA	R_TAG_tx_HRA
R_THF_biomass_COT	R_THF_biomass_COT
R_THF_biomass_HRA	R_THF_biomass_HRA
R_THF_mc_COT	R_THF_mc_COT
R_THF_mc_HRA	R_THF_mc_HRA
R_THF_pc_COT	R_THF_pc_COT
R_THF_pc_HRA	R_THF_pc_HRA
R_THREO-DS-ISO-CITRATE_xc_COT	R_THREO-DS-ISO-CITRATE_xc_COT
R_THREO-DS-ISO-CITRATE_xc_HRA	R_THREO-DS-ISO-CITRATE_xc_HRA
R_THR_pc_COT	R_THR_pc_COT
R_THR_pc_HRA	R_THR_pc_HRA
R_TMP_mc_COT	R_TMP_mc_COT
R_TMP_mc_HRA	R_TMP_mc_HRA
R_TRANSCINNAMATE_biomass_COT	R_TRANSCINNAMATE_biomass_COT
R_TRANSCINNAMATE_biomass_HRA	R_TRANSCINNAMATE_biomass_HRA
R_TRP_pc_COT	R_TRP_pc_COT
R_TRP_pc_HRA	R_TRP_pc_HRA
R_TSA-REDUCT-RXN-NADP_c_COT	TSA-REDUCT-RXN
R_TSA-REDUCT-RXN-NADP_c_HRA	TSA-REDUCT-RXN
R_TSA-REDUCT-RXN-NAD_c_COT	TSA-REDUCT-RXN
R_TSA-REDUCT-RXN-NAD_c_HRA	TSA-REDUCT-RXN
R_TYR_pc_COT	R_TYR_pc_COT
R_TYR_pc_HRA	R_TYR_pc_HRA
R_Tetradecanoyl-CoA_oxi_x_COT	Tetradecanoyl-CoA_oxi
R_Tetradecanoyl-CoA_oxi_x_HRA	Tetradecanoyl-CoA_oxi
R_Threonine-Trans-PHL	R_Threonine-Trans-PHL
R_Tryptophan-Trans-PHL	R_Tryptophan-Trans-PHL
R_Tyrosine-Trans-PHL	R_Tyrosine-Trans-PHL
R_UBIQUINONE_UBIQUINOL_mc_COT	R_UBIQUINONE_UBIQUINOL_mc_COT
R_UBIQUINONE_UBIQUINOL_mc_HRA	R_UBIQUINONE_UBIQUINOL_mc_HRA
R_UCP_mc_COT	R_UCP_mc_COT
R_UCP_mc_HRA	R_UCP_mc_HRA
R_UDP-GLA-galactosyltransferase_c_COT	R_UDP-GLA-galactosyltransferase_c_COT
R_UDP-GLA-galactosyltransferase_c_HRA	R_UDP-GLA-galactosyltransferase_c_HRA
R_UMP_biomass_COT	R_UMP_biomass_COT
R_UMP_biomass_HRA	R_UMP_biomass_HRA
R_URATE_xc_COT	R_URATE_xc_COT
R_URATE_xc_HRA	R_URATE_xc_HRA
R_UTP_pc_COT	R_UTP_pc_COT
R_UTP_pc_HRA	R_UTP_pc_HRA
R_VAL_mc_COT	R_VAL_mc_COT
R_VAL_mc_HRA	R_VAL_mc_HRA
R_VAL_pc_COT	R_VAL_pc_COT
R_VAL_pc_HRA	R_VAL_pc_HRA
R_Valine-Trans-PHL	R_Valine-Trans-PHL
R_Verbascose-Degradation_c_COT	Verbascose-Degradation
R_Verbascose-Degradation_c_HRA	Verbascose-Degradation
R_Verbascose-Trans-PHL	R_Verbascose-Trans-PHL
R_Verbascose_biomass_COT	R_Verbascose_biomass_COT
R_Verbascose_biomass_HRA	R_Verbascose_biomass_HRA
R_X5P_Pi_pc_COT	R_X5P_Pi_pc_COT
R_X5P_Pi_pc_HRA	R_X5P_Pi_pc_HRA
R_Xylan_biomass_COT	R_Xylan_biomass_COT
R_Xylan_biomass_HRA	R_Xylan_biomass_HRA
R_dAMP_biomass_COT	R_dAMP_biomass_COT
R_dAMP_biomass_HRA	R_dAMP_biomass_HRA
R_dCMP_biomass_COT	R_dCMP_biomass_COT
R_dCMP_biomass_HRA	R_dCMP_biomass_HRA
R_dGMP_biomass_COT	R_dGMP_biomass_COT
R_dGMP_biomass_HRA	R_dGMP_biomass_HRA
R_dTMP_biomass_COT	R_dTMP_biomass_COT
R_dTMP_biomass_HRA	R_dTMP_biomass_HRA
R_pALA_biomass_COT	R_pALA_biomass_COT
R_pALA_biomass_HRA	R_pALA_biomass_HRA
R_pARG_biomass_COT	R_pARG_biomass_COT
R_pARG_biomass_HRA	R_pARG_biomass_HRA
R_pASN_biomass_COT	R_pASN_biomass_COT
R_pASN_biomass_HRA	R_pASN_biomass_HRA
R_pASP_biomass_COT	R_pASP_biomass_COT
R_pASP_biomass_HRA	R_pASP_biomass_HRA
R_pCYS_biomass_COT	R_pCYS_biomass_COT
R_pCYS_biomass_HRA	R_pCYS_biomass_HRA
R_pGLN_biomass_COT	R_pGLN_biomass_COT
R_pGLN_biomass_HRA	R_pGLN_biomass_HRA
R_pGLU_biomass_COT	R_pGLU_biomass_COT
R_pGLU_biomass_HRA	R_pGLU_biomass_HRA
R_pGLY_biomass_COT	R_pGLY_biomass_COT
R_pGLY_biomass_HRA	R_pGLY_biomass_HRA
R_pHIS_biomass_COT	R_pHIS_biomass_COT
R_pHIS_biomass_HRA	R_pHIS_biomass_HRA
R_pILE_biomass_COT	R_pILE_biomass_COT
R_pILE_biomass_HRA	R_pILE_biomass_HRA
R_pLEU_biomass_COT	R_pLEU_biomass_COT
R_pLEU_biomass_HRA	R_pLEU_biomass_HRA
R_pLYS_biomass_COT	R_pLYS_biomass_COT
R_pLYS_biomass_HRA	R_pLYS_biomass_HRA
R_pMET_biomass_COT	R_pMET_biomass_COT
R_pMET_biomass_HRA	R_pMET_biomass_HRA
R_pPHE_biomass_COT	R_pPHE_biomass_COT
R_pPHE_biomass_HRA	R_pPHE_biomass_HRA
R_pPRO_biomass_COT	R_pPRO_biomass_COT
R_pPRO_biomass_HRA	R_pPRO_biomass_HRA
R_pSER_biomass_COT	R_pSER_biomass_COT
R_pSER_biomass_HRA	R_pSER_biomass_HRA
R_pTHR_biomass_COT	R_pTHR_biomass_COT
R_pTHR_biomass_HRA	R_pTHR_biomass_HRA
R_pTRP_biomass_COT	R_pTRP_biomass_COT
R_pTRP_biomass_HRA	R_pTRP_biomass_HRA
R_pTYR_biomass_COT	R_pTYR_biomass_COT
R_pTYR_biomass_HRA	R_pTYR_biomass_HRA
R_pVAL_biomass_COT	R_pVAL_biomass_COT
R_pVAL_biomass_HRA	R_pVAL_biomass_HRA
R_s2KG_biomass_COT	R_s2KG_biomass_COT
R_s2KG_biomass_HRA	R_s2KG_biomass_HRA
R_sALA_biomass_COT	R_sALA_biomass_COT
R_sALA_biomass_HRA	R_sALA_biomass_HRA
R_sARG_biomass_COT	R_sARG_biomass_COT
R_sARG_biomass_HRA	R_sARG_biomass_HRA
R_sASN_biomass_COT	R_sASN_biomass_COT
R_sASN_biomass_HRA	R_sASN_biomass_HRA
R_sASP_biomass_COT	R_sASP_biomass_COT
R_sASP_biomass_HRA	R_sASP_biomass_HRA
R_sCIT_biomass_COT	R_sCIT_biomass_COT
R_sCIT_biomass_HRA	R_sCIT_biomass_HRA
R_sCYS_biomass_COT	R_sCYS_biomass_COT
R_sCYS_biomass_HRA	R_sCYS_biomass_HRA
R_sETOH_biomass_COT	R_sETOH_biomass_COT
R_sETOH_biomass_HRA	R_sETOH_biomass_HRA
R_sFRU_biomass_COT	R_sFRU_biomass_COT
R_sFRU_biomass_HRA	R_sFRU_biomass_HRA
R_sFUM_biomass_COT	R_sFUM_biomass_COT
R_sFUM_biomass_HRA	R_sFUM_biomass_HRA
R_sGABA_biomass_COT	R_sGABA_biomass_COT
R_sGABA_biomass_HRA	R_sGABA_biomass_HRA
R_sGLC_biomass_COT	R_sGLC_biomass_COT
R_sGLC_biomass_HRA	R_sGLC_biomass_HRA
R_sGLN_biomass_COT	R_sGLN_biomass_COT
R_sGLN_biomass_HRA	R_sGLN_biomass_HRA
R_sGLU_biomass_COT	R_sGLU_biomass_COT
R_sGLU_biomass_HRA	R_sGLU_biomass_HRA
R_sGLYCOLATE_biomass_COT	R_sGLYCOLATE_biomass_COT
R_sGLYCOLATE_biomass_HRA	R_sGLYCOLATE_biomass_HRA
R_sGLY_biomass_COT	R_sGLY_biomass_COT
R_sGLY_biomass_HRA	R_sGLY_biomass_HRA
R_sHIS_biomass_COT	R_sHIS_biomass_COT
R_sHIS_biomass_HRA	R_sHIS_biomass_HRA
R_sILE_biomass_COT	R_sILE_biomass_COT
R_sILE_biomass_HRA	R_sILE_biomass_HRA
R_sISOCIT_biomass_COT	R_sISOCIT_biomass_COT
R_sISOCIT_biomass_HRA	R_sISOCIT_biomass_HRA
R_sLEU_biomass_COT	R_sLEU_biomass_COT
R_sLEU_biomass_HRA	R_sLEU_biomass_HRA
R_sLYS_biomass_COT	R_sLYS_biomass_COT
R_sLYS_biomass_HRA	R_sLYS_biomass_HRA
R_sMAL_biomass_COT	R_sMAL_biomass_COT
R_sMAL_biomass_HRA	R_sMAL_biomass_HRA
R_sMET_biomass_COT	R_sMET_biomass_COT
R_sMET_biomass_HRA	R_sMET_biomass_HRA
R_sORN_biomass_COT	R_sORN_biomass_COT
R_sORN_biomass_HRA	R_sORN_biomass_HRA
R_sPHE_biomass_COT	R_sPHE_biomass_COT
R_sPHE_biomass_HRA	R_sPHE_biomass_HRA
R_sPRO_biomass_COT	R_sPRO_biomass_COT
R_sPRO_biomass_HRA	R_sPRO_biomass_HRA
R_sPYROGLU_biomass_COT	R_sPYROGLU_biomass_COT
R_sPYROGLU_biomass_HRA	R_sPYROGLU_biomass_HRA
R_sSER_biomass_COT	R_sSER_biomass_COT
R_sSER_biomass_HRA	R_sSER_biomass_HRA
R_sSUCROSE_biomass_COT	R_sSUCROSE_biomass_COT
R_sSUCROSE_biomass_HRA	R_sSUCROSE_biomass_HRA
R_sSUC_biomass_COT	R_sSUC_biomass_COT
R_sSUC_biomass_HRA	R_sSUC_biomass_HRA
R_sTHR_biomass_COT	R_sTHR_biomass_COT
R_sTHR_biomass_HRA	R_sTHR_biomass_HRA
R_sTRP_biomass_COT	R_sTRP_biomass_COT
R_sTRP_biomass_HRA	R_sTRP_biomass_HRA
R_sTYR_biomass_COT	R_sTYR_biomass_COT
R_sTYR_biomass_HRA	R_sTYR_biomass_HRA
R_sUREA_biomass_COT	R_sUREA_biomass_COT
R_sUREA_biomass_HRA	R_sUREA_biomass_HRA
R_sVAL_biomass_COT	R_sVAL_biomass_COT
R_sVAL_biomass_HRA	R_sVAL_biomass_HRA
